artículo,marca,código,característica,unidad de medida,fecha,tipo,detalle,cantidad,saldo,precio unitario,precio total
bobinas de anillo doble ring,TNIN RING WIRE,,,bobina,2007-10-15,entrada,o/c 650,4,4,,
cartulina folcote calibre 10,,,,resma 70x100x100 - 1r = 100 hojas,2005-12-09,entrada,o/c 522,1000,1000,,
cartulina folcote calibre 10,,,,resma 70x100x100 - 1r = 100 hojas,2006-09-01,salida,oficio 151-2006-jcm/uncp,60,940,,
cartulina folcote calibre 10,,,,resma 70x100x100 - 1r = 100 hojas,2007-09-05,salida,historias clinicas y kardex,200,740,,
cartulina folcote calibre 10,,,,resma 70x100x100 - 1r = 100 hojas,2009-04-06,salida,kardex centro medico,100,640,,
cartulina folcote calibre 10,,,,resma 70x100x100 - 1r = 100 hojas,2009-06-10,salida,tarjeta invitación aulas virtuales,40,600,,
cartulina folcote calibre 10,,,,resma 70x100x100 - 1r = 100 hojas,2009-11-26,salida,comisión organizadora 50 años carnets deportivos,100,500,,
cartulina folcote calibre 10,,,,resma 70x100x100 - 1r = 100 hojas,2010-03-29,salida,1 resma pastas plan operativo y memoria 2008,100,400,,
cartulina folcote calibre 10,,,,resma 70x100x100 - 1r = 100 hojas,2010-05-07,salida,27 hojas caratula prospecto 2010 medicina,27,373,,
cartulina folcote calibre 10,,,,resma 70x100x100 - 1r = 100 hojas,2010-09-30,salida,6 hojas caratula plan estrategico planif. 2010,6,367,,
cartulina folcote calibre 10,,,,resma 70x100x100 - 1r = 100 hojas,2010-12-05,salida,8 hojas invitaciones aniversario,9,298,,
cartulina folcote calibre 10,,,,resma 70x100x100 - 1r = 100 hojas,2010-12-07,salida,70 hojas invitaciones aniversario,70,228,,
cartulina folcote calibre 10,,,,resma 70x100x100 - 1r = 100 hojas,2010-12-07,entrada,restante desglosado = 4 paquetes x 100 hojas,172,400,,
cartulina folcote calibre 10,,,,resma 70x100x100 - 1r = 100 hojas,2011-07-27,entrada,5 resmas x 100 hojas pe00806,500,900,75.36,376.8
cartulina folcote calibre 10,,,,resma 70x100x100 - 1r = 100 hojas,2011-08-25,salida,50 hojas ceritificados evento convenio fac. enfermería,50,850,,
cartulina folcote calibre 10,,,,resma 70x100x100 - 1r = 100 hojas,2011-09-19,salida,42 hojas folder registros académicos,42,808,,
cartulina folcote calibre 10,,,,resma 70x100x100 - 1r = 100 hojas,2011-09-19,salida,8 hojas folder registros académicos,8,800,,
cartulina folcote calibre 10,,,,resma 70x100x100 - 1r = 100 hojas,2011-10-10,salida,empastado de actas de archivo central,3,797,,
cartulina folcote calibre 10,,,,resma 70x100x100 - 1r = 100 hojas,2011-10-11,salida,5 hojas certificado de proyección social,5,792,,
cartulina folcote calibre 10,,,,resma 70x100x100 - 1r = 100 hojas,2011-10-12,salida,taller libum uncp,10,782,,
cartulina folcote calibre 10,,,,resma 70x100x100 - 1r = 100 hojas,2011-10-13,salida,30 hojas de vicerrectorado academico,30,752,,
cartulina folcote calibre 10,,,,resma 70x100x100 - 1r = 100 hojas,2011-10-28,salida,29 pliegos,29,723,,
cartulina folcote calibre 10,,,,resma 70x100x100 - 1r = 100 hojas,2011-11-30,salida,12 pliegos libros de secretaria general,12,711,,
cartulina satinada 150 gramos 69x89,,,,5 ciento = 500 unidades,2011-09-26,entrada,,500,500,,
cartón nº 8 de 1.00 x 0.70,,,,pliego,2009-06-09,entrada,o/c 465,300,300,,
cartón nº 8 de 1.00 x 0.70,,,,pliego,2009-06-17,salida,14 planchas empastadas auditoria,14,286,,
cartón nº 8 de 1.00 x 0.70,,,,pliego,2009-07-07,salida,7 cartones membretados fac. soc. med. ind.,7,279,,
cartón nº 8 de 1.00 x 0.70,,,,pliego,2009-07-24,salida,7 cartones membretados sec. general,7,272,,
cartón nº 8 de 1.00 x 0.70,,,,pliego,2009-09-21,salida,14 pliegos cartón oficina abastecimientos,14,258,,
cartón nº 8 de 1.00 x 0.70,,,,pliego,2009-11-23,salida,6 pliegos cartón fac. cont. minas,6,252,,
cartón nº 8 de 1.00 x 0.70,,,,pliego,2009-11-24,salida,empastado de planillas,17,235,,
cartón nº 8 de 1.00 x 0.70,,,,pliego,2009-12-23,salida,empaste libros sistemas,2,233,,
cartón nº 8 de 1.00 x 0.70,,,,pliego,2009-12-29,salida,empaste documentos auditoria,13,220,,
cartón nº 8 de 1.00 x 0.70,,,,pliego,2010-02-02,salida,empaste documentos vicerrector académico,11,209,,
cartón nº 8 de 1.00 x 0.70,,,,pliego,2010-03-10,salida,empaste planillas,4,205,,
cartón nº 8 de 1.00 x 0.70,,,,pliego,2010-03-22,salida,empaste ingenieria civil,4,201,,
cartón nº 8 de 1.00 x 0.70,,,,pliego,2010-04-07,salida,empaste medicina,2,199,,
cartón nº 8 de 1.00 x 0.70,,,,pliego,2010-04-13,salida,empaste fac. sociologia,2,197,,
cartón nº 8 de 1.00 x 0.70,,,,pliego,2010-04-14,salida,empaste medicina,4,193,,
cartón nº 8 de 1.00 x 0.70,,,,pliego,2010-04-28,salida,empaste pronacap (vice rec. académico),10,183,,
cartón nº 8 de 1.00 x 0.70,,,,pliego,2010-05-12,salida,empastado auditoria,3,180,,
cartón nº 8 de 1.00 x 0.70,,,,pliego,2010-05-26,salida,empastado sec. general,7,173,,
cartón nº 8 de 1.00 x 0.70,,,,pliego,2010-06-03,salida,empastado auditoria,11,162,,
cartón nº 8 de 1.00 x 0.70,,,,pliego,2010-08-02,salida,empastado sec. general,33,129,,
cartón nº 8 de 1.00 x 0.70,,,,pliego,2010-09-02,salida,"empastado sociologia, industrias",3,126,,
cartón nº 8 de 1.00 x 0.70,,,,pliego,2010-09-17,salida,empastado vicerrectorado académico,4,122,,
cartón nº 8 de 1.00 x 0.70,,,,pliego,2010-09-30,salida,43 empastes registros académicos,43,79,,
cartón nº 8 de 1.00 x 0.70,,,,pliego,2010-12-06,salida,5 empastados fac. pedagogía,5,74,,
cartón nº 8 de 1.00 x 0.70,,,,pliego,2010-12-17,salida,2 empastados fac. forestales,2,72,,
cartón nº 8 de 1.00 x 0.70,,,,pliego,2010-12-22,salida,4 empastados cs. aplicadas tarma,4,68,,
cartón nº 8 de 1.00 x 0.70,,,,pliego,2010-12-30,salida,2 empastados oficina de publicaciones,2,66,,
cartón nº 8 de 1.00 x 0.70,,,,pliego,2011-01-24,salida,4 empastados oficina de publicaciones,4,62,,
cartón nº 8 de 1.00 x 0.70,,,,pliego,2011-02-16,salida,40 empastados auditoria,40,22,,
cartón nº 8 de 1.00 x 0.70,,,,pliego,2011-03-11,salida,11 empastes auditoria registros,11,11,,
cartón nº 8 de 1.00 x 0.70,,,,pliego,2011-09-05,entrada,pecosa pe01136,400,411,83,332
cartón nº 8 de 1.00 x 0.70,,,,pliego,2011-09-23,salida,empastados oficina tesoreria,12,399,,
cartón nº 8 de 1.00 x 0.70,,,,pliego,2011-10-10,salida,empastados de actas archivo central,3,396,,
cartón nº 8 de 1.00 x 0.70,,,,pliego,2011-10-11,salida,empastados de actas archivo central,1,395,,
cartón nº 8 de 1.00 x 0.70,,,,pliego,2011-11-11,salida,empastados secretaria general,14,381,,
cartón nº 8 de 1.00 x 0.70,,,,pliego,2011-11-30,salida,6 pliegos empastado de archivo central,6,375,,
cartón nº 8 de 1.00 x 0.70,,,,pliego,2011-12-13,salida,3 pliegos empastado de libros de secretaria general,3,372,,
cartulina satinada 150 gramos 50x65 colores,,,,unidad,2010-10-19,entrada,pecosa 121696,500,500,0.24,120
cartulina satinada 150 gramos 50x65 colores,,,,unidad,2010-12-17,salida,empastado facultad forestales,2,498,,
cartulina satinada 150 gramos 50x65 colores,,,,unidad,2010-12-22,salida,empastado silabos cs. aplicadas tarma,22,478,,
cartulina satinada 150 gramos 50x65 colores,,,,unidad,2010-12-30,salida,empastado oficina de publicaciones,11,467,,
cartulina satinada 150 gramos 50x65 colores,,,,unidad,2011-01-24,salida,empastado oficina de publicaciones,15,452,,
cartulina satinada 150 gramos 50x65 colores,,,,unidad,2011-02-16,salida,empastado auditoria,52,400,,
cartulina satinada 150 gramos 50x65 colores,,,,unidad,2011-02-25,salida,confeccion de kardex control,25,375,,
cartulina satinada 150 gramos 50x65 colores,,,,unidad,2011-03-11,salida,empastado auditoria registros y materiales,55,320,,
cartulina satinada 150 gramos 50x65 colores,,,,unidad,2011-03-23,entrada,100 pliegos pecosa,100,420,,
cartulina satinada 150 gramos 50x65 colores,,,,unidad,2011-04-01,salida,empastados auditoria,35,385,,
cartulina satinada 150 gramos 50x65 colores,,,,unidad,2011-04-12,salida,empastados facultad pedagogia,7,378,,
cartulina satinada 150 gramos 50x65 colores,,,,unidad,2011-04-18,salida,empastado libros de sec. general,4,374,,
cartulina satinada 150 gramos 50x65 colores,,,,unidad,2011-04-20,salida,empastados facultad de zootecnia,3,371,,
cartulina satinada 150 gramos 50x65 colores,,,,unidad,2011-04-28,salida,planillas,50,321,,
cartulina satinada 150 gramos 50x65 colores,,,,unidad,2011-05-13,salida,pliegos fac. soc. tarma,6,315,,
cartulina satinada 150 gramos 50x65 colores,,,,unidad,2011-06-28,salida,pliegos empastado tesoreria,6,309,,
cartulina satinada 150 gramos 50x65 colores,,,,unidad,2011-07-04,salida,pliegos empastado tesoreria,10,299,,
cartulina satinada 150 gramos 50x65 colores,,,,unidad,2011-07-11,salida,pliegos empastado tesoreria,9,290,,
cartulina satinada 150 gramos 50x65 colores,,,,unidad,2011-08-02,salida,pliegos empastado tesoreria,12,278,,
cartulina satinada 150 gramos 50x65 colores,,,,unidad,2011-08-26,salida,"empastados fac. ind, alimentarias",7,270,,
cartulina satinada 150 gramos 50x65 colores,,,,unidad,2011-09-01,salida,empastados secretaria general,20,250,,
cartulina satinada 150 gramos 50x65 colores,,,,unidad,2011-09-05,salida,empastados oficina de publicaciones,3,247,,
cartulina satinada 150 gramos 50x65 colores,,,,unidad,2011-09-23,salida,empastados tesoreria,8,239,,
cartulina satinada 150 gramos 50x65 colores,,,,unidad,2011-10-10,salida,empastados de actas archivo central,25,214,,
cartulina satinada 150 gramos 50x65 colores,,,,unidad,2011-11-11,salida,empastados secretaria general,55,159,,
cartulina satinada 150 gramos 50x65 colores,,,,unidad,2011-11-30,salida,empastados de archivo,15,144,,
cartulina satinada 150 gramos 69x89,,,,unidad,2011-09-26,entrada,,500,500,72,360
"cinta de embalaje 2"" x 25 ydas",SHURT,,,unidad,2006-02-28,entrada,pe 00092,60,60,,
"cinta de embalaje 2"" x 25 ydas",SHURT,,,unidad,2006-02-28,salida,,2,58,,
"cinta de embalaje 2"" x 25 ydas",SHURT,,,unidad,2007-07-04,salida,,1,57,,
"cinta de embalaje 2"" x 25 ydas",SHURT,,,unidad,2007-11-19,salida,,2,55,,
"cinta de embalaje 2"" x 25 ydas",SHURT,,,unidad,2007-12-03,salida,,1,54,,
"cinta de embalaje 2"" x 25 ydas",SHURT,,,unidad,2007-02-12,salida,,2,52,,
"cinta de embalaje 2"" x 25 ydas",SHURT,,,unidad,2007-03-19,salida,,1,51,,
"cinta de embalaje 2"" x 25 ydas",SHURT,,,unidad,2008-04-01,salida,,2,49,,
"cinta de embalaje 2"" x 25 ydas",SHURT,,,unidad,2008-04-04,salida,,1,48,,
"cinta de embalaje 2"" x 25 ydas",SHURT,,,unidad,2008-04-08,salida,,1,47,,
"cinta de embalaje 2"" x 25 ydas",SHURT,,,unidad,2008-04-15,salida,,1,46,,
"cinta de embalaje 2"" x 25 ydas",SHURT,,,unidad,2008-04-23,salida,,1,45,,
"cinta de embalaje 2"" x 25 ydas",SHURT,,,unidad,2008-05-19,salida,,1,44,,
"cinta de embalaje 2"" x 25 ydas",SHURT,,,unidad,2008-06-05,salida,,1,43,,
"cinta de embalaje 2"" x 25 ydas",SHURT,,,unidad,2008-06-17,salida,,1,42,,
"cinta de embalaje 2"" x 25 ydas",SHURT,,,unidad,2008-06-30,salida,,1,41,,
"cinta de embalaje 2"" x 25 ydas",SHURT,,,unidad,2008-07-14,salida,,1,40,,
"cinta de embalaje 2"" x 25 ydas",SHURT,,,unidad,2008-07-21,salida,,1,39,,
"cinta de embalaje 2"" x 25 ydas",SHURT,,,unidad,2008-08-04,salida,,1,38,,
"cinta de embalaje 2"" x 25 ydas",SHURT,,,unidad,2008-08-19,salida,,2,36,,
"cinta de embalaje 2"" x 25 ydas",SHURT,,,unidad,2008-08-28,salida,,1,35,,
"cinta de embalaje 2"" x 25 ydas",SHURT,,,unidad,2008-09-02,entrada,pecosa 01366,15,50,,
"cinta de embalaje 2"" x 25 ydas",SHURT,,,unidad,2008-09-12,salida,,1,49,,
"cinta de embalaje 2"" x 25 ydas",SHURT,,,unidad,2008-11-17,salida,,1,48,,
"cinta de embalaje 2"" x 25 ydas",SHURT,,,unidad,2008-11-20,salida,,2,46,,
"cinta de embalaje 2"" x 25 ydas",SHURT,,,unidad,2009-02-05,salida,,1,45,,
"cinta de embalaje 2"" x 25 ydas",SHURT,,,unidad,2009-03-18,salida,,1,44,,
"cinta de embalaje 2"" x 25 ydas",SHURT,,,unidad,2009-04-16,salida,,1,43,,
"cinta de embalaje 2"" x 25 ydas",SHURT,,,unidad,2009-05-06,salida,,1,42,,
"cinta de embalaje 2"" x 25 ydas",SHURT,,,unidad,2009-06-01,salida,,1,41,,
"cinta de embalaje 2"" x 25 ydas",SHURT,,,unidad,2009-07-02,salida,,1,40,,
"cinta de embalaje 2"" x 25 ydas",SHURT,,,unidad,2009-07-07,salida,,1,39,,
"cinta de embalaje 2"" x 25 ydas",SHURT,,,unidad,2009-07-20,salida,,1,38,,
"cinta de embalaje 2"" x 25 ydas",SHURT,,,unidad,2009-08-31,salida,,1,37,,
"cinta de embalaje 2"" x 25 ydas",SHURT,,,unidad,2009-08-31,salida,,1,36,,
"cinta de embalaje 2"" x 25 ydas",SHURT,,,unidad,2009-09-22,salida,,1,35,,
"cinta de embalaje 2"" x 25 ydas",SHURT,,,unidad,2009-11-02,entrada,pecosa,12,47,,
"cinta de embalaje 2"" x 25 ydas",SHURT,,,unidad,2009-12-09,salida,,1,46,,
"cinta de embalaje 2"" x 25 ydas",SHURT,,,unidad,2010-01-21,salida,,1,45,,
"cinta de embalaje 2"" x 25 ydas",SHURT,,,unidad,2010-02-11,salida,,2,43,,
"cinta de embalaje 2"" x 25 ydas",SHURT,,,unidad,2010-03-17,salida,,2,41,,
"cinta de embalaje 2"" x 25 ydas",SHURT,,,unidad,2010-03-30,salida,,1,40,,
"cinta de embalaje 2"" x 25 ydas",SHURT,,,unidad,2010-04-12,salida,,1,39,,
"cinta de embalaje 2"" x 25 ydas",SHURT,,,unidad,2010-04-16,salida,,1,38,,
"cinta de embalaje 2"" x 25 ydas",SHURT,,,unidad,2010-06-02,salida,,1,37,,
"cinta de embalaje 2"" x 25 ydas",SHURT,,,unidad,2010-07-12,salida,,1,36,,
"cinta de embalaje 2"" x 25 ydas",SHURT,,,unidad,2010-07-14,salida,,1,35,,
"cinta de embalaje 2"" x 25 ydas",SHURT,,,unidad,2010-08-10,salida,,1,34,,
"cinta de embalaje 2"" x 25 ydas",SHURT,,,unidad,2010-08-24,entrada,pecosa,7,41,,
"cinta de embalaje 2"" x 25 ydas",SHURT,,,unidad,2010-09-23,salida,,1,40,,
"cinta de embalaje 2"" x 25 ydas",SHURT,,,unidad,2010-10-12,salida,,1,39,,
"cinta de embalaje 2"" x 25 ydas",SHURT,,,unidad,2010-10-22,salida,,1,38,,
"cinta de embalaje 2"" x 25 ydas",SHURT,,,unidad,2010-12-09,salida,,2,36,,
"cinta de embalaje 2"" x 25 ydas",SHURT,,,unidad,2011-01-03,salida,,1,35,,
"cinta de embalaje 2"" x 25 ydas",SHURT,,,unidad,2011-01-03,salida,,1,34,,
"cinta de embalaje 2"" x 25 ydas",SHURT,,,unidad,2011-01-24,salida,,1,33,,
"cinta de embalaje 2"" x 25 ydas",SHURT,,,unidad,2011-01-31,salida,,1,32,,
"cinta de embalaje 2"" x 25 ydas",SHURT,,,unidad,2011-03-23,entrada,pecosa,10,42,,
"cinta de embalaje 2"" x 25 ydas",SHURT,,,unidad,2011-04-05,salida,,1,41,,
"cinta de embalaje 2"" x 25 ydas",SHURT,,,unidad,2011-07-01,salida,,1,40,,
"cinta de embalaje 2"" x 25 ydas",SHURT,,,unidad,2011-10-06,salida,,1,39,,
"cinta de embalaje 2"" x 25 ydas",SHURT,,,unidad,2011-11-21,salida,,1,38,,
"cinta de embalaje 2"" x 25 ydas",SHURT,,,unidad,2011-11-24,salida,,1,37,,
"cinta de embalaje 2"" x 25 ydas",SHURT,,,unidad,2011-12-05,entrada,pecosa 02000,6,43,1.19,7.14
cola blanca p/binder duplo db280,,,,kilos,2011-09-26,entrada,,50,50,18.76,938
cola elástica (gráfica),FULLER,,,balde,2005-12-09,entrada,o/c522,6,6,,
cola elástica (gráfica),FULLER,,,balde,2007-08-29,salida,,1,5,,
cola gráfica,INDUSTRIAS IDEAL S.A.,,,balde,2007-02-28,entrada,,9,9,,
cola gráfica,INDUSTRIAS IDEAL S.A.,,,balde,2007-02-28,salida,,1,8,,
cola gráfica,INDUSTRIAS IDEAL S.A.,,,balde,2007-12-21,salida,,1,7,,
cola sintética,MULTICOLA,,,balde x 4 kls.,2011-07-27,entrada,,15,15,18,270
cola sintética,MULTICOLA,,,balde x 4 kls.,2011-09-01,salida,,1,14,,
cola sintética,MULTICOLA,,,balde x 4 kls.,2011-11-11,salida,,1,13,,
corrector de placas,,,,,2005-03-10,entrada,o/c982,3,3,,
corrector de placas,,,,,2006-01-03,salida,,1,2,,
corrector de placas,,,,,2007-12-12,salida,,1,1,,
corrector de placas,,,,,2008-07-25,entrada,o/c332,2,3,,
corrector de placas,,,,,2008-12-11,salida,,1,2,,
cuchillo metálico (repuestos stanley),,,,10 cajita (c/u x 10 unidades = 100 cuchillitos),2005-09-30,entrada,o/c859,10,10,,
cuchillo metálico (repuestos stanley),,,,10 cajita (c/u x 10 unidades = 100 cuchillitos),2005-09-30,salida,,1,9,,
cuchillo metálico (repuestos stanley),,,,11 cajita (c/u x 10 unidades = 100 cuchillitos),2006-05-16,salida,,1,8,,
cuchillo metálico (repuestos stanley),,,,12 cajita (c/u x 10 unidades = 100 cuchillitos),2006-10-02,salida,,0.5,7.5,,
cuchillo metálico (repuestos stanley),,,,13 cajita (c/u x 10 unidades = 100 cuchillitos),2009-05-14,salida,,0.5,7,,
cuchillos metálicos tipo bisturi (repuestos stanley),,,,cajita x 25,2005-09-30,entrada,o/c859 4 cajas x 100 saldo al 03/11/2005,100,100,,
cuchillos metálicos tipo bisturi (repuestos stanley),,,,cajita x 25,2006-09-15,salida,,25,75,,
cuchillos metálicos tipo bisturi (repuestos stanley),,,,cajita x 25,2007-08-10,salida,,25,50,,
cuchillos metálicos tipo bisturi (repuestos stanley),,,,cajita x 25,2008-09-10,salida,,25,25,,
cuchillos metálicos tipo bisturi (repuestos stanley),,,,cajita x 25,2010-06-01,salida,,1,24,,
esponjas o gayetas,,44515206,,unidad,2004-11-19,entrada,o/c 984-peo1180,10,10,,
esponjas o gayetas,,44515206,,unidad,2005-03-10,salida,,3,7,,
esponjas o gayetas,,44515206,,unidad,2005-05-17,entrada,o/c 197,24,31,,
esponjas o gayetas,,44515206,,unidad,2005-11-03,salida,,2,29,,
esponjas o gayetas,,44515206,,unidad,2006-05-16,salida,,1,28,,
esponjas o gayetas,,44515206,,unidad,2006-05-29,salida,,1,27,,
esponjas o gayetas,,44515206,,unidad,2006-09-07,salida,,1,26,,
esponjas o gayetas,,44515206,,unidad,2006-09-29,salida,,1,25,,
esponjas o gayetas,,44515206,,unidad,2007-01-05,salida,,1,24,,
esponjas o gayetas,,44515206,,unidad,2007-01-28,salida,,3,21,,
esponjas o gayetas,,44515206,,unidad,2007-12-21,salida,,4,17,,
esponjas o gayetas,,44515206,,unidad,2008-04-21,salida,,1,16,,
esponjas o gayetas,,44515206,,unidad,2008-08-15,salida,,1,15,,
esponjas o gayetas,,44515206,,unidad,2008-11-21,salida,,1,14,,
esponjas o gayetas,,44515206,,unidad,2009-02-05,salida,,1,13,,
esponjas o gayetas,,44515206,,unidad,2009-06-01,salida,,1,12,,
esponjas o gayetas,,44515206,,unidad,2009-08-31,salida,,1,11,,
esponjas o gayetas,,44515206,,unidad,2009-12-17,salida,,1,10,,
esponjas o gayetas,,44515206,,unidad,2009-12-18,salida,,2,8,,
esponjas o gayetas,,44515206,,unidad,2010-04-19,salida,,1,7,,
esponjas o gayetas,,44515206,,unidad,2010-07-14,salida,,1,6,,
esponjas o gayetas,,44515206,,unidad,2010-08-23,salida,,1,5,,
esponjas o gayetas,,44515206,,unidad,2010-10-01,salida,,1,4,,
esponjas o gayetas,,44515206,,unidad,2010-10-28,entrada,pe01757,10,14,,
esponjas o gayetas,,44515206,,unidad,2011-05-13,salida,,2,12,,
glicerina q. p.,FIGHER U.S.A.,,,galones,2005-04-14,entrada,pe 00386 (1 galonera),6,6,,
goma protectora,GUMMI,44515212,por 4 litros,galón,2004-12-30,entrada,o/c 1024 - peo1461,1,1,,
goma protectora,GUMMI,44515212,por 4 litros,galón,2004-11-09,entrada,o/c 684 - pe01180,3,4,,
goma protectora,GUMMI,44515212,por 4 litros,galón,2005-11-03,salida,,0.5,3.5,,
goma protectora,GUMMI,44515212,por 4 litros,galón,2005-12-15,salida,,0.5,3,,
goma protectora,GUMMI,44515212,por 4 litros,galón,2006-05-16,salida,,0.5,2.5,,
goma protectora,GUMMI,44515212,por 4 litros,galón,2006-10-31,salida,,0.25,2.25,,
goma protectora,GUMMI,44515212,por 4 litros,galón,2007-01-03,salida,,0.25,2,,
goma protectora,GUMMI,44515212,por 4 litros,galón,2007-05-29,salida,,0.5,1.5,,
goma protectora,GUMMI,44515212,por 4 litros,galón,2007-07-26,entrada,o/c 00527,1,2.5,,
goma protectora,GUMMI,44515212,por 4 litros,galón,2008-03-05,salida,,0.25,2.25,,
goma protectora,GUMMI,44515212,por 4 litros,galón,2008-10-15,salida,,0.15,2.1,,
goma protectora,GUMMI,44515212,por 4 litros,galón,2010-10-05,salida,,0.1,2,,
goma protectora,GUMMI,44515212,por 4 litros,galón,2010-10-28,entrada,pe 01757,2,4,,
goma protectora,GUMMI,44515212,por 4 litros,galón,2011-09-01,salida,,0.5,3.5,,
grapas n° 23/8,MIRAGE,44360450,,,2004-11-05,entrada,pe01164,10,10,,
grapas n° 23/8,MIRAGE,44360450,,,2005-04-14,entrada,,10,20,,
grapas n° 23/8,MIRAGE,44360450,,,2005-11-03,salida,,1,19,,
grapas n° 23/8,MIRAGE,44360450,,,2006-10-04,salida,,2,17,,
grapas n° 23/10,MIRAGE,44360445,,cajitas,2004-11-05,entrada,pe01164,10,10,,
grapas n° 23/10,MIRAGE,44360445,,cajitas,2005-04-14,entrada,,10,20,,
grapas n° 23/10,MIRAGE,44360445,,cajitas,2005-11-03,salida,,1,19,,
grapas n° 23/10,MIRAGE,44360445,,cajitas,2005-11-08,entrada,encontrado al arreglar la oficina de pub. e impresiones,1,20,,
grapas n° 23/10,MIRAGE,44360445,,cajitas,2006-12-13,salida,,1,19,,
grapas 23/12,MIRAGE,44360440,,cajitas,2004-11-05,entrada,peo 1163,10,10,,
grapas 23/12,MIRAGE,44360440,,cajitas,2005-04-14,entrada,,10,20,,
grapas 23/12,MIRAGE,44360440,,cajitas,2005-11-08,entrada,encontrado al arreglar la oficina de pub. e impresiones,5,25,,
grapas 23/12,MIRAGE,44360440,,cajitas,2007-03-05,salida,,2,23,,
grapas 23/15,MIRAGE,44360435,,cajitas,2004-01-05,entrada,peo1163,10,10,,
grapas 23/15,MIRAGE,44360435,,cajitas,2005-04-14,entrada,,10,20,,
grapas 23/15,MIRAGE,44360435,,cajitas,2005-11-03,salida,,1,19,,
grapas 23/15,MIRAGE,44360435,,cajitas,2005-11-08,entrada,encontrado al arreglar la oficina de pub. e impresiones,3,22,,
grapas 23/15,MIRAGE,44360435,,cajitas,2006-01-05,salida,,1,21,,
grapas 23/15,MIRAGE,44360435,,cajitas,2006-11-23,salida,,1,20,,
grapas 23/15,MIRAGE,44360435,,cajitas,2011-07-21,salida,,1,19,,
grapas n° 23/6,SKREBBA,,,cajitas,2007-09-12,entrada,o/c 679 - pe01253,12,12,,
grapas n° 23/6,SKREBBA,,,cajitas,2010-10-09,salida,,1,11,,
grapas 23/8,SKREBBA,,,cajitas,2007-09-12,entrada,o/c 679 - pe01253,12,12,,
grapas 23/8,SKREBBA,,,cajitas,2008-02-08,entrada,memoria 2006,1,11,,
grapas 23/8,SKREBBA,,,cajitas,2009-01-15,entrada,815 revistas informativas de investigación,2,9,,
grapa n° 23/12,SKREBBA,,,cajitas,2007-09-12,entrada,o/c 679 - pe01253,12,12,,
grapa n° 23/12,SKREBBA,,,cajitas,2008-11-14,salida,1 caja memoria,1,11,,
grapa 23/15,SKREBBA,,,cajitas,2007-02-28,entrada,o/c 0018,20,20,,
grapa 23/15,SKREBBA,,,cajitas,2007-03-07,salida,,1,19,,
grapa 23/15,SKREBBA,,,cajitas,2007-05-05,salida,,1,18,,
grapa 23/15,SKREBBA,,,cajitas,2011-07-22,salida,,1,17,,
grapas staples dbm,,,,cajita x 5000 grapas,2011-08-19,entrada,pe 01075,120,120,4,480
kit de drum unit. gpr-20 black,,,black,unidad,2010-08-25,entrada,,4,4,880,3520
kit de drum unit. gpr-20 black,,,black,unidad,2010-09-14,salida,,1,3,,
kit de drum unit. gpr-20 black,,,black,unidad,2011-09-01,salida,,1,2,,
kit de drum unit. gpr-20 black,,,black,unidad,2011-12-07,salida,,1,1,,
kit de drum unit. gpr-20 cyan,,,cyan,unidad,2010-08-26,entrada,,2,2,1245,2490
kit de drum unit. gpr-20 cyan,,,cyan,unidad,2011-09-01,salida,,1,1,,
kit de drum unit. gpr-20 cyan,,,cyan,unidad,2011-12-07,salida,,1,0,,
kit de drum unit. gpr-20 magenta,,,magenta,unidad,2010-08-27,entrada,,2,2,1245,2490
kit de drum unit. gpr-20 magenta,,,magenta,unidad,2011-09-01,salida,,1,1,,
kit de drum unit. gpr-20 magenta,,,magenta,unidad,2011-12-07,salida,,1,0,,
kit de drum unit. gpr-20 yellow,,,yellow,unidad,2010-08-28,entrada,,4,4,1245,4980
kit de drum unit. gpr-20 yellow,,,yellow,unidad,2011-09-01,salida,,1,3,,
kit de drum unit. gpr-20 yellow,,,yellow,unidad,2011-12-07,salida,,1,2,,
limpiador de rodillos,LINGRAF,,,galones x 4 litros,2008-07-25,entrada,o/c 332,20,20,,
limpiador de rodillos,LINGRAF,,,galones x 4 litros,2008-11-25,salida,,2,18,,
limpiador de rodillos,LINGRAF,,,galones x 4 litros,2008-11-15,salida,,1,17,,
limpiador de rodillos,LINGRAF,,,galones x 4 litros,2009-02-09,salida,,4,13,,
limpiador de rodillos,LINGRAF,,,galones x 4 litros,2009-03-18,salida,,2,11,,
limpiador de rodillos,LINGRAF,,,galones x 4 litros,2009-04-08,salida,,1,10,,
limpiador de rodillos,LINGRAF,,,galones x 4 litros,2009-06-12,salida,,2,8,,
limpiador de rodillos,LINGRAF,,,galones x 4 litros,2009-07-03,salida,,2,6,,
limpiador de rodillos,LINGRAF,,,galones x 4 litros,2009-08-27,salida,,1,5,,
limpiador de rodillos,LINGRAF,,,galones x 4 litros,2009-09-11,salida,,2,3,,
limpiador de rodillos,LINGRAF,,,galones x 4 litros,2009-12-04,salida,,1,2,,
limpiador de rodillos,LINGRAF,,,galones x 4 litros,2009-12-23,entrada,o/c 1136 pe 2036,20,22,,
limpiador de rodillos,LINGRAF,,,galones x 4 litros,2010-01-05,salida,,2,20,,
limpiador de rodillos,LINGRAF,,,galones x 4 litros,2010-05-12,salida,,4,16,,
limpiador de rodillos,LINGRAF,,,galones x 4 litros,2010-08-19,salida,,4,12,,
limpiador de rodillos,LINGRAF,,,galones x 4 litros,2010-11-05,salida,,4,8,,
limpiador de rodillos,LINGRAF,,,galones x 4 litros,2010-10-28,entrada,pe 01757 - 15 galones,60,68,31,465
limpiador de rodillos,LINGRAF,,,galones x 4 litros,2010-11-12,salida,mantenimiento gasto heidelberg,8,60,,
limpiador de rodillos,LINGRAF,,,galones x 4 litros,2011-01-27,salida,,4,56,,
limpiador de rodillos,LINGRAF,,,galones x 4 litros,2011-04-10,salida,1 galon,4,52,,
limpiador de rodillos,LINGRAF,,,galones x 4 litros,2011-07-12,salida,2 galones,8,44,,
limpiador de rodillos,LINGRAF,,,galones x 4 litros,2011-08-18,salida,1 galon,4,40,,
limpiador de rodillos,LINGRAF,,,galones x 4 litros,2011-10-18,salida,1 galon,4,36,,
limpiador de rodillos,PREGO,,,galones x 4 litros,2011-07-27,entrada,,8,8,27,216
"renar, limpiador de tinta seca",ANTARIS,,,frascos x 1 litro,2011-07-27,entrada,,5,5,25,125
"renar, limpiador de tinta seca",ANTARIS,,,frascos x 1 litro,2011-08-08,salida,,1,4,,
mantillas comprensibles 445x520x1.95,,,,unidad,2005-05-17,entrada,,5,5,,
mantillas comprensibles 445x520x1.95,,,,unidad,2005-12-21,salida,,1,4,,
mantillas comprensibles 445x520x1.95,,,,unidad,2006-10-02,salida,,1,3,,
mantillas comprensibles 445x520x1.95,,,,unidad,2007-01-25,salida,,1,2,,
mantillas comprensibles 445x520x1.95,,,,unidad,2007-01-31,salida,,1,1,,
mantillas comprensibles 445x520x1.95,,,,unidad,2007-04-23,salida,,1,0,,
mantillas comprensibles 445x520x1.95,,,,unidad,2008-05-29,entrada,o/c 00331,5,5,,
mantillas comprensibles 445x520x1.95,,,,unidad,2008-11-27,salida,,1,4,,
mantillas comprensibles 445x520x1.95,,,,unidad,2008-12-15,salida,,1,3,,
mantillas comprensibles 445x520x1.95,,,,unidad,2009-07-31,salida,,1,2,,
mantillas comprensibles 445x520x1.95,,,,unidad,2009-12-17,salida,,1,1,,
mantillas comprensibles 445x520x1.95,,,,unidad,2010-07-02,salida,,1,0,,
mantillas comprensibles 445x520x1.95,,,,unidad,2010-10-28,entrada,pe 01757,5,5,,
mantillas comprensibles 445x520x1.95,,,,unidad,2010-12-20,salida,,1,4,,
opalina de 70x100 x 180 gramos,FEDRIGONI,,,resma x 100 hojas,2011-07-27,entrada,,300,300,100,300
opalina de 70x100 x 180 gramos,FEDRIGONI,,,resma x 100 hojas,2011-12-13,salida,tarjetas de invitacion 75 pliegos aniversario,75,225,,
papel bond 75 gramos de 69x89x500,,,,resma,2011-09-26,entrada,,20,20,116.7,2334
papel bond 75 gramos de 69x89x500,,,,resma,2011-10-12,salida,cambio por ta4,1,19,,
papel bond 75 gramos de 69x89x500,,,,resma,2011-10-24,salida,,2.335,16.165,,
papel bond 75 gramos de 69x89x500,,,,resma,2011-12-13,salida,,65,16.1,,
papel bond 80 gramos tamaño a4,ATLAS,,,millar,2007-07-02,entrada,10 millares a4,10,10,,
papel bond 80 gramos tamaño a4,ATLAS,,,millar,2007-07-10,salida,cambio con t/o,1.5,8.5,,
papel bond 80 gramos tamaño a4,ATLAS,,,millar,2007-07-16,salida,of. publicaciones,0.5,8,,
papel bond 80 gramos tamaño a4,ATLAS,,,millar,2007-07-18,salida,almacen cambio por oficio (-3),3,5,,
papel bond 80 gramos tamaño a4,ATLAS,,,millar,2007-08-16,salida,almacen cambio por oficio (-5),5,0,,
papel bond 80 gramos tamaño a4,ATLAS,,,millar,2007-09-04,entrada,almacen cambio por oficio,5,5,,
papel bond 80 gramos tamaño a4,ATLAS,,,millar,2007-09-04,salida,para uso de la oficina de publicaciones,0.5,4.5,,
papel bond 80 gramos tamaño a4,ATLAS,,,millar,2007-09-25,salida,1/2 millar para uso de la oficina de publicaciones,0.5,4,,
papel bond 80 gramos tamaño a4,ATLAS,,,millar,2007-10-15,salida,1/2 millar para uso de la oficina de publicaciones,0.5,3.5,,
papel bond 80 gramos tamaño a4,ATLAS,,,millar,2007-11-23,entrada,se cambia a secretaria general mas 5,5,8.5,,
papel bond 80 gramos tamaño a4,ATLAS,,,millar,2008-01-09,salida,menos 1 millar se cambio almacen por t/o,1,7.5,,
papel bond 80 gramos tamaño a4,ATLAS,,,millar,2008-01-10,salida,1/2 millar para uso de la oficina de publicaciones,0.5,7,,
papel bond 80 gramos tamaño a4,ATLAS,,,millar,2008-01-25,salida,menos 2 millares cambio por t/o,2,5,,
papel bond 80 gramos tamaño a4,ATLAS,,,millar,2008-01-28,salida,1/2 millar para uso de la oficina de publicaciones,0.5,4.5,,
papel bond 80 gramos tamaño a4,ATLAS,,,millar,2008-02-12,salida,menos 1 millar se cambio almacen por t/o,1,3.5,,
papel bond 80 gramos tamaño a4,ATLAS,,,millar,2008-02-19,salida,1 millar vice rectorado académico,1,2.5,,
papel bond 80 gramos tamaño a4,ATLAS,,,millar,2008-02-19,salida,1/2 millar para uso de la oficina de publicaciones,0.5,2,,
papel bond 80 gramos tamaño a4,ATLAS,,,millar,2008-04-01,salida,1 millar cambio por t/o,1,1,,
papel bond 80 gramos tamaño a4,ATLAS,,,millar,2008-04-09,salida,1/2 millar para uso de la oficina de publicaciones,0.5,0.5,,
papel bond 80 gramos tamaño a4,ATLAS,,,millar,2008-05-15,salida,1/2 millar para uso de la oficina de publicaciones,0.5,0,,
papel bond 80 gramos tamaño a4,ATLAS,,,millar,2008-06-16,entrada,6 millares cambio por t/o,6,6,,
papel bond 80 gramos tamaño a4,ATLAS,,,millar,2008-07-14,salida,1 millar cambio por t/o,1,5,,
papel bond 80 gramos tamaño a4,ATLAS,,,millar,2008-07-24,salida,1/2 millar cambio por t/o,0.5,4.5,,
papel bond 80 gramos tamaño a4,ATLAS,,,millar,2008-08-07,salida,2 millares cambio por t/o,2,2.5,,
papel bond 80 gramos tamaño a4,ATLAS,,,millar,2008-08-11,salida,1 millar cambio por t/o,1,1.5,,
papel bond 80 gramos tamaño a4,ATLAS,,,millar,2008-08-12,entrada,5 millares cambio por t/o,5,6.5,,
papel bond 80 gramos tamaño a4,ATLAS,,,millar,2008-08-27,salida,1/2 millar cambio por t/o,0.5,6,,
papel bond 80 gramos tamaño a4,ATLAS,,,millar,2008-08-28,salida,1/2 millar para uso de la oficina de publicaciones,0.5,5.5,,
papel bond 80 gramos tamaño a4,ATLAS,,,millar,2008-08-28,salida,5 millares cambio por t/o,5,0.5,,
papel bond 80 gramos tamaño a4,ATLAS,,,millar,2008-09-22,salida,1/2 millar para uso de la oficina de publicaciones,0.5,0,,
papel bond 80 gramos tamaño a4,ATLAS,,,millar,2009-02-27,entrada,devolucion 2 millares t/o secretaria general,2,2,,
papel bond 80 gramos tamaño a4,ATLAS,,,millar,2009-03-10,salida,cambio por 1 millar t/o,1,1,,
papel bond 80 gramos tamaño a4,ATLAS,,,millar,2009-03-11,salida,1/2 millar cambio por t/o,0.5,0.5,,
papel bond 80 gramos tamaño a4,ATLAS,,,millar,2009-03-11,entrada,80 millares pecosa pe 00148,80,80.5,,
papel bond 80 gramos tamaño a4,ATLAS,,,millar,2009-03-12,salida,6 millares membretado rectorado vicerrectorado,6,74.5,,
papel bond 80 gramos tamaño a4,ATLAS,,,millar,2009-03-23,salida,1/2 millar para uso de la oficina de publicaciones,0.5,74,,
papel bond 80 gramos tamaño a4,ATLAS,,,millar,2009-04-22,salida,1 millar cambio por t/o,1,73,,
papel bond 80 gramos tamaño a4,ATLAS,,,millar,2009-04-27,salida,1/2 millar para uso de la oficina de publicaciones,0.5,72.5,,
papel bond 80 gramos tamaño a4,ATLAS,,,millar,2009-05-08,salida,1/2 millar para uso de la oficina de publicaciones,0.5,72,,
papel bond 80 gramos tamaño a4,ATLAS,,,millar,2009-05-12,salida,1 millar cambio por t/o,1,71,,
papel bond 80 gramos tamaño a4,ATLAS,,,millar,2009-05-13,salida,3 millares cambio por t/o,3,68,,
papel bond 80 gramos tamaño a4,ATLAS,,,millar,2009-05-21,salida,1 1/2 millar cambio por t/o,1.5,66.5,,
papel bond 80 gramos tamaño a4,ATLAS,,,millar,2009-06-01,salida,3 millares cambio por t/o,3,63.5,,
papel bond 80 gramos tamaño a4,ATLAS,,,millar,2009-06-25,salida,1/2 millar cambio por t/o,0.5,63,,
papel bond 80 gramos tamaño a4,ATLAS,,,millar,2009-06-26,salida,1/2 millar cambio por t/o,0.5,62.5,,
papel bond 80 gramos tamaño a4,ATLAS,,,millar,2009-07-02,salida,4 millares membretes fac. sociologia y sistemas,4,58.5,,
papel bond 80 gramos tamaño a4,ATLAS,,,millar,2009-07-07,salida,1/2 millar trabajo de oficina,0.5,58,,
papel bond 80 gramos tamaño a4,ATLAS,,,millar,2009-07-08,salida,1/2 millar cambio por t/o,0.5,57.5,,
papel bond 80 gramos tamaño a4,ATLAS,,,millar,2009-07-09,salida,1/2 millar cambio por t/o,0.5,57,,
papel bond 80 gramos tamaño a4,ATLAS,,,millar,2009-08-20,salida,1/2 millar cambio por t/o,0.5,56.5,,
papel bond 80 gramos tamaño a4,ATLAS,,,millar,2009-08-27,salida,4 millares membretes fac. satipo y abastecimientos,4,52.5,,
papel bond 80 gramos tamaño a4,ATLAS,,,millar,2009-09-04,salida,1/2 millar para uso de la oficina de publicaciones,0.5,52,,
papel bond 80 gramos tamaño a4,ATLAS,,,millar,2009-09-10,salida,1/2 millar cambio por t/o,0.5,51.5,,
papel bond 80 gramos tamaño a4,ATLAS,,,millar,2009-09-14,salida,2 millares membretes facultad ing. quimica,2,49.5,,
papel bond 80 gramos tamaño a4,ATLAS,,,millar,2009-09-21,salida,1/2 millar cambio por t/o,0.5,49,,
papel bond 80 gramos tamaño a4,ATLAS,,,millar,2009-09-22,salida,1 millar cambio por t/o,1,48,,
papel bond 80 gramos tamaño a4,ATLAS,,,millar,2009-09-22,salida,3 millares cambio por t/o,3,45,,
papel bond 80 gramos tamaño a4,ATLAS,,,millar,2009-09-23,salida,"6 millares membretado medicina, pedagogia, electrica",6,39,,
papel bond 80 gramos tamaño a4,ATLAS,,,millar,2009-10-01,salida,"14 millares membretado fac.adm.agr.arq.cscom.contmf,minas,tarma,civil",14,25,,
papel bond 80 gramos tamaño a4,ATLAS,,,millar,2009-10-02,salida,1/2 millar para uso de la oficina de publicaciones,0.5,24.5,,
papel bond 80 gramos tamaño a4,ATLAS,,,millar,2009-10-05,salida,1/2 millar cambio por t/o,0.5,24,,
papel bond 80 gramos tamaño a4,ATLAS,,,millar,2009-10-12,salida,1/2 millar cambio por t/o,0.5,23.5,,
papel bond 80 gramos tamaño a4,ATLAS,,,millar,2009-10-16,salida,1/2 millar cambio por t/o,0.5,23,,
papel bond 80 gramos tamaño a4,ATLAS,,,millar,2009-10-20,salida,1/2 millar cambio por t/o,0.5,22.5,,
papel bond 80 gramos tamaño a4,ATLAS,,,millar,2009-11-02,salida,2 millares proyeccion soc. planificacion,2,20.5,,
papel bond 80 gramos tamaño a4,ATLAS,,,millar,2009-11-09,salida,1/2 millar para uso de la oficina de publicaciones,0.5,20,,
papel bond 80 gramos tamaño a4,ATLAS,,,millar,2009-11-16,salida,1/2 millar cambio por t/o,0.5,19.5,,
papel bond 80 gramos tamaño a4,ATLAS,,,millar,2009-11-24,salida,2 millares cambio por t/o,2,17.5,,
papel bond 80 gramos tamaño a4,ATLAS,,,millar,2009-11-24,salida,5 millares cambio por t/o,5,12.5,,
papel bond 80 gramos tamaño a4,ATLAS,,,millar,2009-12-14,salida,1 1/2 millar agenda 2010,1.5,11,,
papel bond 80 gramos tamaño a4,ATLAS,,,millar,2009-12-14,salida,1/2 millar para uso de la oficina de publicaciones,0.5,10.5,,
papel bond 80 gramos tamaño a4,ATLAS,,,millar,2010-01-13,entrada,1 1/2 millar cambio por t/o,1.5,12,,
papel bond 80 gramos tamaño a4,ATLAS,,,millar,2010-01-15,salida,1/2 millar para uso de la oficina de publicaciones,0.5,11.5,,
papel bond 80 gramos tamaño a4,ATLAS,,,millar,2010-02-24,salida,1/2 millar cambio por t/o,0.5,11,,
papel bond 80 gramos tamaño a4,ATLAS,,,millar,2010-02-19,salida,1 millar cambio por papel bond de color,1,10,,
papel bond 80 gramos tamaño a4,ATLAS,,,millar,2010-03-10,salida,2 millares cambio por t/o,2,8,,
papel bond 80 gramos tamaño a4,ATLAS,,,millar,2010-03-11,salida,1/2 millar cambio por t/o,0.5,7.5,,
papel bond 80 gramos tamaño a4,ATLAS,,,millar,2010-03-12,salida,1/2 millar para uso de la oficina de publicaciones,0.5,7,,
papel bond 80 gramos tamaño a4,ATLAS,,,millar,2010-03-15,salida,1/2 millar cambio por t/o,0.5,6.5,,
papel bond 80 gramos tamaño a4,ATLAS,,,millar,2010-03-16,salida,1 millar cambio por t/o,1,5.5,,
papel bond 80 gramos tamaño a4,ATLAS,,,millar,2010-03-25,salida,1/2 millar pruebas compaginadora y encoladora,0.5,5,,
papel bond 80 gramos tamaño a4,ATLAS,,,millar,2010-03-25,salida,2 millares cambio por t/o,2,3,,
papel bond 80 gramos tamaño a4,ATLAS,,,millar,2010-04-05,salida,2 millares cambio por t/o,2,1,,
papel bond 80 gramos tamaño a4,ATLAS,,,millar,2010-04-13,salida,1/2 millar oficina bienestar,0.5,0.5,,
papel bond 80 gramos tamaño a4,ATLAS,,,millar,2010-04-13,salida,1/2 millar documentacion oficina,0.5,0,,
papel bond 80 gramos tamaño a4,ATLAS,,,millar,2011-02-25,entrada,13.5 millares de la conversion del papel tamaño resma 69x89x500,13.5,13.5,,
papel bond 80 gramos tamaño a4,ATLAS,,,millar,2011-02-25,salida,1 millar se cambio por t/o,1,12.5,,
papel bond 80 gramos tamaño a4,ATLAS,,,millar,2011-02-25,salida,1/2 millar para uso de la oficina de publicaciones,0.5,12,,
papel bond 80 gramos tamaño a4,ATLAS,,,millar,2011-03-11,salida,1/2 millar cambio por t/o,0.5,11.5,,
papel bond 80 gramos tamaño a4,ATLAS,,,millar,2011-03-18,salida,1/2 millar para uso de la oficina de publicaciones,0.5,11,,
papel bond 80 gramos tamaño a4,ATLAS,,,millar,2011-03-22,salida,1 millar para uso de la oficina de publicaciones,0.5,10.5,,
papel bond 80 gramos tamaño a4,ATLAS,,,millar,2011-04-13,salida,1 millar cambio por t/o,1,9.5,,
papel bond 80 gramos tamaño a4,ATLAS,,,millar,2011-05-09,salida,2 millares cambio por t/o,2,7.5,,
papel bond 80 gramos tamaño a4,ATLAS,,,millar,2011-05-11,salida,2 millares cambio por t/o,2,5.5,,
papel bond 80 gramos tamaño a4,ATLAS,,,millar,2011-07-04,salida,1/2 millar cambio por t/o,0.5,5,,
papel bond 80 gramos tamaño a4,ATLAS,,,millar,2011-08-18,salida,3 millares cambio por t/o,3,2,,
papel bond 80 gramos tamaño a4,ATLAS,,,millar,2011-08-22,salida,1/2 millar cambio para uso de la oficina,0.5,1.5,,
papel bond 80 gramos tamaño a4,ATLAS,,,millar,2011-09-02,salida,1/2 millar cambio por t/o,0.5,1,,
papel bond 80 gramos tamaño a4,ATLAS,,,millar,2011-09-08,salida,1/2 millar para uso de la oficina de publicaciones,0.5,0.5,,
papel bond 80 gramos tamaño a4,ATLAS,,,millar,2011-09-21,entrada,1 millar cambio por t/o,1,1.5,,
papel bond 80 gramos tamaño a4,ATLAS,,,millar,2011-09-28,salida,1/2 millar cambio por t/o,0.5,1,,
papel bond 80 gramos tamaño a4,ATLAS,,,millar,2011-09-30,salida,1/2 millar cambio por t/o,0.5,0.5,,
papel bond 80 gramos tamaño a4,ATLAS,,,millar,2011-10-12,entrada,4 millares cambio por t/resma,4,4.5,,
papel bond 80 gramos tamaño a4,ATLAS,,,millar,2011-10-13,salida,uso de la oficina 1/2 millar,0.5,4,,
papel bond 80 gramos tamaño a4,ATLAS,,,millar,2011-10-14,salida,1 1/2 millar cambio por t/o,1.5,2.5,,
papel bond 80 gramos tamaño oficio,ATLAS,,,millar,2007-07-02,entrada,5 millares t/of,5,5,,
papel bond 80 gramos tamaño oficio,ATLAS,,,millar,2007-07-10,entrada,cambio con a4,1.5,6.5,,
papel bond 80 gramos tamaño oficio,ATLAS,,,millar,2007-07-18,entrada,almacen cambio por a4,3,9.5,,
papel bond 80 gramos tamaño oficio,ATLAS,,,millar,2007-08-16,entrada,almacen cambio por a4,5,14.5,,
papel bond 80 gramos tamaño oficio,ATLAS,,,millar,2007-09-04,salida,se cambio por papel bond a4,5,9.5,,
papel bond 80 gramos tamaño oficio,ATLAS,,,millar,2007-11-23,salida,se cambio a secretaria general,5,4.5,,
papel bond 80 gramos tamaño oficio,ATLAS,,,millar,2008-01-09,entrada,se cambio por a4,1,5.5,,
papel bond 80 gramos tamaño oficio,ATLAS,,,millar,2008-01-25,entrada,se cambio por a4,2,7.5,,
papel bond 80 gramos tamaño oficio,ATLAS,,,millar,2008-02-12,entrada,se cambio por a4,1,8.5,,
papel bond 80 gramos tamaño oficio,ATLAS,,,millar,2008-02-22,salida,1/2 millar para uso de oficina de publicaciones,0.5,8,,
papel bond 80 gramos tamaño oficio,ATLAS,,,millar,2008-04-01,entrada,se cambio por a4,1,9,,
papel bond 80 gramos tamaño oficio,ATLAS,,,millar,2008-06-16,salida,se cambio por a4,6,3,,
papel bond 80 gramos tamaño oficio,ATLAS,,,millar,2008-07-14,entrada,se cambio por a4,1,4,,
papel bond 80 gramos tamaño oficio,ATLAS,,,millar,2008-07-24,entrada,se cambio por a4,0.5,4.5,,
papel bond 80 gramos tamaño oficio,ATLAS,,,millar,2008-08-07,entrada,se cambio por a4,2,6.5,,
papel bond 80 gramos tamaño oficio,ATLAS,,,millar,2008-08-11,entrada,se cambio por a4,1,7.5,,
papel bond 80 gramos tamaño oficio,ATLAS,,,millar,2008-08-12,salida,se cambio por a4,5,2.5,,
papel bond 80 gramos tamaño oficio,ATLAS,,,millar,2008-08-27,entrada,se cambio por a4,0.5,3,,
papel bond 80 gramos tamaño oficio,ATLAS,,,millar,2008-08-28,entrada,se cambio por a4,5,8,,
papel bond 80 gramos tamaño oficio,ATLAS,,,millar,2009-02-09,salida,2 millares para membrete secretaria general,2,6,,
papel bond 80 gramos tamaño oficio,ATLAS,,,millar,2009-03-10,entrada,se cambio por a4,1,7,,
papel bond 80 gramos tamaño oficio,ATLAS,,,millar,2009-03-11,entrada,se cambio por a4,0.5,7.5,,
papel bond 80 gramos tamaño oficio,ATLAS,,,millar,2009-04-22,entrada,se cambio por a4,1,8.5,,
papel bond 80 gramos tamaño oficio,ATLAS,,,millar,2009-05-12,entrada,se cambio por a4,1,9.5,,
papel bond 80 gramos tamaño oficio,ATLAS,,,millar,2009-05-18,entrada,se cambio por a4,3,12.5,,
papel bond 80 gramos tamaño oficio,ATLAS,,,millar,2009-05-21,entrada,se cambio por a4,1.5,14,,
papel bond 80 gramos tamaño oficio,ATLAS,,,millar,2009-06-04,entrada,se cambio por a4,3,17,,
papel bond 80 gramos tamaño oficio,ATLAS,,,millar,2009-06-25,entrada,se cambio por a4,0.5,17.5,,
papel bond 80 gramos tamaño oficio,ATLAS,,,millar,2009-06-26,entrada,se cambio por a4,0.5,18,,
papel bond 80 gramos tamaño oficio,ATLAS,,,millar,2009-07-08,entrada,se cambio por a4,0.5,18.5,,
papel bond 80 gramos tamaño oficio,ATLAS,,,millar,2009-07-09,entrada,se cambio por a4,0.5,19,,
papel bond 80 gramos tamaño oficio,ATLAS,,,millar,2009-08-20,entrada,se cambio por a4,0.5,19.5,,
papel bond 80 gramos tamaño oficio,ATLAS,,,millar,2009-09-03,salida,7 millares a cambio de 3 millares de papel doble oficio 90 gramos,7,12.5,,
papel bond 80 gramos tamaño oficio,ATLAS,,,millar,2009-09-10,entrada,se cambio por a4,0.5,13,,
papel bond 80 gramos tamaño oficio,ATLAS,,,millar,2009-09-21,entrada,se cambio por a4,0.5,13.5,,
papel bond 80 gramos tamaño oficio,ATLAS,,,millar,2009-09-22,entrada,se cambio por a4,1,14.5,,
papel bond 80 gramos tamaño oficio,ATLAS,,,millar,2009-09-22,entrada,se cambio por a4,3,17.5,,
papel bond 80 gramos tamaño oficio,ATLAS,,,millar,2009-10-05,entrada,se cambio por a4,0.5,18,,
papel bond 80 gramos tamaño oficio,ATLAS,,,millar,2009-10-12,entrada,se cambio por a4,0.5,18.5,,
papel bond 80 gramos tamaño oficio,ATLAS,,,millar,2009-10-16,entrada,se cambio por a4,0.5,19,,
papel bond 80 gramos tamaño oficio,ATLAS,,,millar,2009-10-20,entrada,se cambio por a4,0.5,19.5,,
papel bond 80 gramos tamaño oficio,ATLAS,,,millar,2009-11-16,entrada,se cambio por a4,0.5,20,,
papel bond 80 gramos tamaño oficio,ATLAS,,,millar,2009-11-24,entrada,se cambio por a4,2,22,,
papel bond 80 gramos tamaño oficio,ATLAS,,,millar,2009-11-24,entrada,se cambio por a4,5,27,,
papel bond 80 gramos tamaño oficio,ATLAS,,,millar,2010-01-13,salida,se cambio por a4,1.5,25.5,,
papel bond 80 gramos tamaño oficio,ATLAS,,,millar,2010-01-22,salida,se cambio por a4,0.5,25,,
papel bond 80 gramos tamaño oficio,ATLAS,,,millar,2010-02-04,salida,14 millares a cambio por papel de la oficina de sec. general con resmas de 50x33x500 de 120 gramos,14,11,,
papel bond 80 gramos tamaño oficio,ATLAS,,,millar,2010-02-19,entrada,se cambio por a4,0.5,11.5,,
papel bond 80 gramos tamaño oficio,ATLAS,,,millar,2010-03-10,entrada,se cambio por a4,2,13.5,,
papel bond 80 gramos tamaño oficio,ATLAS,,,millar,2010-03-11,entrada,se cambio por a4,0.5,14,,
papel bond 80 gramos tamaño oficio,ATLAS,,,millar,2010-03-15,entrada,se cambio por a4,0.5,14.5,,
papel bond 80 gramos tamaño oficio,ATLAS,,,millar,2010-03-16,entrada,se cambio por a4,1,15.5,,
papel bond 80 gramos tamaño oficio,ATLAS,,,millar,2010-03-19,entrada,se cambio por a4,1,16.5,,
papel bond 80 gramos tamaño oficio,ATLAS,,,millar,2010-03-25,entrada,se cambio por a4,2,18.5,,
papel bond 80 gramos tamaño oficio,ATLAS,,,millar,2010-04-05,entrada,se cambio por a4,2,20.5,,
papel bond 80 gramos tamaño oficio,ATLAS,,,millar,2010-09-28,salida,1.5 millar planes estrategicos al 2016,1.5,19,,
papel bond 80 gramos tamaño oficio,ATLAS,,,millar,2010-12-20,salida,1 millar para uso de la oficina de publicaciones,1,18,,
papel bond 80 gramos tamaño oficio,ATLAS,,,millar,2011-02-25,entrada,se cambio por a4,1,19,,
papel bond 80 gramos tamaño oficio,ATLAS,,,millar,2011-03-11,entrada,se cambio por a4,0.5,19.5,,
papel bond 80 gramos tamaño oficio,ATLAS,,,millar,2011-04-13,entrada,se cambio por a4,1,20.5,,
papel bond 80 gramos tamaño oficio,ATLAS,,,millar,2011-05-09,entrada,se cambio por a4,2,22.5,,
papel bond 80 gramos tamaño oficio,ATLAS,,,millar,2011-05-11,entrada,se cambio por a4,2,24.5,,
papel bond 80 gramos tamaño oficio,ATLAS,,,millar,2011-07-04,entrada,se cambio por a4,0.5,25,,
papel bond 80 gramos tamaño oficio,ATLAS,,,millar,2011-08-18,entrada,se cambio por a4,3,28,,
papel bond 80 gramos tamaño oficio,ATLAS,,,millar,2011-09-02,entrada,se cambio por a4,0.5,28.5,,
papel bond 80 gramos tamaño oficio,ATLAS,,,millar,2011-09-21,salida,1 millar a cambio por ta4,1,27.5,,
papel bond 80 gramos tamaño oficio,ATLAS,,,millar,2011-09-28,entrada,se cambio por a4,0.5,28,,
papel bond 80 gramos tamaño oficio,ATLAS,,,millar,2011-09-30,entrada,se cambio por a4,0.5,28.5,,
papel bond 80 gramos tamaño oficio,ATLAS,,,millar,2011-10-14,entrada,1 1/2 millar cambio por ta4,1.5,30,,
papel canson a3 110/115gr,CBIT,,,millar,2007-11-27,entrada,o/c 678,4000,4000,,
papel canson a3 110/115gr,CBIT,,,millar,2008-11-07,salida,1/2 millar,500,3500,,
papel canson a3 110/115gr,CBIT,,,millar,2008-11-18,salida,250 hojas,250,3250,,
papel canson a3 110/115gr,CBIT,,,millar,2009-01-09,salida,750 hojas,750,2500,,
papel couche brillante 115 gramos 69x89,EUROART PLUS,,paquetes de 250 hojas x 2 = 500 hojas,resma 69x89x500,2007-12-31,entrada,o/c 01149 2 paquetes x 2 de 250 hojas c/u,20,20,,
papel couche brillante 115 gramos 69x90,EUROART PLUS,,paquetes de 250 hojas x 2 = 500 hojas,resma 69x89x500,2008-12-05,salida,plan institucional 08 1/2 resma,0.5,19.5,,
papel couche brillante 115 gramos 69x91,EUROART PLUS,,paquetes de 250 hojas x 2 = 500 hojas,resma 69x89x500,2009-07-31,salida,tríptico unidad post grado fac. cs. comunicación 1/2 r,0.5,19,,
papel couche brillante 115 gramos 69x92,EUROART PLUS,,paquetes de 250 hojas x 2 = 500 hojas,resma 69x89x500,2009-12-11,salida,guia del estudiante (50) y halcon (100),2,17,,
papel couche brillante 115 gramos 69x93,EUROART PLUS,,paquetes de 250 hojas x 2 = 500 hojas,resma 69x89x500,2010-03-10,salida,completar 10 millares guias del estudiante 2008,3,14,,
papel couche brillante 115 gramos 69x94,EUROART PLUS,,paquetes de 250 hojas x 2 = 500 hojas,resma 69x89x500,2010-03-29,salida,plan operativo 2010 memoria 2008,2.5,11.5,,
papel couche brillante 115 gramos 69x95,EUROART PLUS,,paquetes de 250 hojas x 2 = 500 hojas,resma 69x89x500,2010-06-25,salida,convenio fundacion fraternitas univ triptico,2.5,9,,
papel couche brillante 115 gramos 69x96,EUROART PLUS,,paquetes de 250 hojas x 2 = 500 hojas,resma 69x89x500,2010-12-07,salida,programas aniversario,1,8,,
papel couche brillante 115 gramos 69x96,EUROART PLUS,,paquetes de 250 hojas x 2 = 500 hojas,resma x 125 hojas,2011-10-14,salida,1 resma para anuario estadistico 2010,1,7,,
papel couche mate 150 gramos 72x102,,,,resma x 500 hojas,2011-08-10,entrada,5 resmas,2500,2500,277.15,1385.75
papel couche mate 150 gramos 72x102,,,,resma x 500 hojas,2011-11-21,salida,52 hojas para afiches de acreditacion,52,2448,,
papel couche mate 72x102 200 gramos,SUNBRITE,,,resma x 125 hojas,2011-07-27,entrada,5 resmas de 125 hojas,625,625,70,350
papel couche mate 72x102 200 gramos,SUNBRITE,,,resma x 125 hojas,2011-08-11,salida,50 hojas,50,575,,
papel couche mate 72x102 200 gramos,SUNBRITE,,,resma x 125 hojas,2011-09-08,salida,13 hojas,13,562,,
papel couche mate 72x102 200 gramos,SUNBRITE,,,resma x 125 hojas,2011-09-19,salida,6 hojas,6,556,,
papel couche mate 72x102 200 gramos,SUNBRITE,,,resma x 125 hojas,2011-11-17,salida,20 hojas afiche del espejo de gandhi,20,536,,
papel couche 300 gramos,,,,hoja cortada en 4,2007-01-31,entrada,500 hojas cortadas en 4,2000,2000,,
papel couche 300 gramos,,,,hoja cortada en 4,2007-03-07,salida,tarjetas de invitación apertura del año académico,550,1450,,
papel couche 300 gramos,,,,hoja cortada en 4,2007-03-15,salida,tarjetas de pensión post grado adm.,60,1390,,
papel couche 300 gramos,,,,hoja cortada en 4,2007-03-16,salida,tarjetas de pensión post grado adm.,60,1330,,
papel couche 300 gramos,,,,hoja cortada en 4,2007-05-11,salida,caratula plan de funcionamiento 2007,150,1180,,
papel couche 300 gramos,,,,hoja cortada en 4,2007-07-31,salida,invitaciones y recuerdos inauguracion museo 2007,70,1100,,
papel couche 300 gramos,,,,hoja cortada en 4,2007-08-21,salida,pasta nuevo reglamento de control,310,700,,
papel couche 300 gramos,,,,hoja cortada en 4,2008-01-15,salida,caratulas memoria 2006,150,550,,
papel couche 300 gramos,,,,hoja cortada en 4,2008-03-19,salida,hojas para el calendario académico para docentes,150,400,,
papel couche 300 gramos,,,,hoja cortada en 4,2010-04-23,salida,tarjetas dia de la secretaria y psicologo,100,300,,
papel couche 300 gramos,,,,hoja cortada en 4,2010-05-05,salida,tarjetas del dia de la madre,160,140,,
pasta suavizante,,,,kilo,2011-09-26,entrada,,3,3,22,66
placas (chicas),MULTILIFT,,,,2005-11-03,entrada,saldo,13,13,,
placas (chicas),MULTILIFT,,,,2007-01-24,salida,placa para prueba de revelados,1,12,,
placas (chicas),MULTILIFT,,,,2007-02-21,salida,bienestar formato visitas domiciliarias,1,11,,
placas (chicas),MULTILIFT,,,,2008-11-28,salida,,1,10,,
placas metálicas ctp direct inkjet plate 400x510x0.15,,,,unidad,2010-01-07,entrada,,100,100,,
placas metálicas ctp direct inkjet plate 400x510x0.15,,,,unidad,2010-06-25,salida,convenio fundacion fraternitas universales uncp,4,96,,
placas metálicas ctp direct inkjet plate 400x510x0.15,,,,unidad,2010-07-02,salida,velo en una placa para el convenio fraternitas uncp,1,95,,
placas metálicas ctp direct inkjet plate 400x510x0.15,,,,unidad,2010-07-06,salida,tripticos convenio fundacion fraternitas,4,91,,
placas metálicas ctp direct inkjet plate 400x510x0.15,,,,unidad,2010-07-08,salida,1 placa tripticos convenio fundacion fraternitas,1,90,,
placas metálicas ctp direct inkjet plate 400x510x0.15,,,,unidad,2010-07-08,salida,4 placas afiches grandes 36x51,4,86,,
placas metálicas ctp direct inkjet plate 400x510x0.15,,,,unidad,2010-07-21,salida,4 placas capacitación refuerzo con lingraf,4,82,,
placas metálicas ctp direct inkjet plate 400x510x0.15,,,,unidad,2010-07-22,salida,placas capacitacion lingraf,4,78,,
placas metálicas ctp direct inkjet plate 400x510x0.15,,,,unidad,2010-08-12,salida,4 placas membrete facultad de medicina,4,74,,
placas metálicas ctp direct inkjet plate 400x510x0.15,,,,unidad,2010-08-25,salida,8 placas cs. comunicación y tramite documentario,8,66,,
placas metálicas ctp direct inkjet plate 400x510x0.15,,,,unidad,2010-10-20,salida,2 placas membrete memorandum oficina de tramite documentario,2,64,,
placas metálicas ctp direct inkjet plate 400x510x0.15,,,,unidad,2010-10-21,salida,2 placas membrete memorandum oficina de tramite documentario,2,62,,
placas metálicas ctp direct inkjet plate 400x510x0.15,,,,unidad,2010-10-28,entrada,pecosa pe 01757 200,200,262,461.16,922.32
placas metálicas ctp direct inkjet plate 400x510x0.15,,,,unidad,2010-11-16,salida,5 placas afiche semana de la calidad,5,257,,
placas metálicas ctp direct inkjet plate 400x510x0.15,,,,unidad,2010-11-18,salida,2 placas programa semana de la calidad,2,255,,
placas metálicas ctp direct inkjet plate 400x510x0.15,,,,unidad,2010-12-07,salida,5 placas programa aniversario,5,250,,
placas metálicas ctp direct inkjet plate 400x510x0.15,,,,unidad,2010-12-07,salida,3 placas invitaciones aniversario,3,247,,
placas metálicas ctp direct inkjet plate 400x510x0.15,,,,unidad,2010-12-14,salida,8 placas membretados mantenimiento y cooperación técnica,8,239,,
placas metálicas ctp direct inkjet plate 400x510x0.15,,,,unidad,2010-12-14,salida,2 placas membretados de la of. de cooperacion tecnica,2,237,,
placas metálicas ctp direct inkjet plate 400x510x0.15,,,,unidad,2010-12-20,salida,4 placas calendario cosmobiologico,4,233,,
placas metálicas ctp direct inkjet plate 400x510x0.15,,,,unidad,2011-01-26,salida,1 cuna reg. academ.,1,232,,
placas metálicas ctp direct inkjet plate 400x510x0.15,,,,unidad,2011-03-14,salida,4 tarjetas de invitacion apertura año academico 2011,4,228,,
placas metálicas ctp direct inkjet plate 400x510x0.15,,,,unidad,2011-03-31,salida,2 placas para dar mantenimiento al equipo ctp por la empresa lingraf,2,226,,
placas metálicas ctp direct inkjet plate 400x510x0.15,,,,unidad,2011-04-01,salida,2 placas para dar mantenimiento al equipo ctp por la empresa lingraf,2,224,,
placas metálicas ctp direct inkjet plate 400x510x0.15,,,,unidad,2011-05-05,salida,4 placas tarjetas dia de la madre,4,220,,
placas metálicas ctp direct inkjet plate 400x510x0.15,,,,unidad,2011-05-09,salida,8 placas triptico orientacion vocacional zootecnia,8,212,,
placas metálicas ctp direct inkjet plate 400x510x0.15,,,,unidad,2011-05-09,salida,4 placas triptico membrete fac. medicina,4,208,,
placas metálicas ctp direct inkjet plate 400x510x0.15,,,,unidad,2011-05-11,salida,4 placas triptico investigacion feria ciencias orientacion vocacional,4,204,,
placas metálicas ctp direct inkjet plate 400x510x0.15,,,,unidad,2011-06-09,salida,1 placa para reemplazar placa fallada triptico zootecnia,1,203,,
placas metálicas ctp direct inkjet plate 400x510x0.15,,,,unidad,2011-07-08,salida,8 placas para el triptico de biblioteca,8,195,,
placas metálicas ctp direct inkjet plate 400x510x0.15,,,,unidad,2011-07-11,salida,2 placas para el triptico de biblioteca,2,193,,
placas metálicas ctp direct inkjet plate 400x510x0.15,,,,unidad,2011-08-09,salida,3 placas para tramite documentario notificacion,3,190,,
placas metálicas ctp direct inkjet plate 400x510x0.15,,,,unidad,2011-08-15,salida,4 placas para pastoral universitaria,4,186,,
placas metálicas ctp direct inkjet plate 400x510x0.15,,,,unidad,2011-09-22,salida,4 placas para triptico de biblioteca,4,182,,
placas convencionales,,,,unidad,2006-11-15,entrada,o/c 1054,500,500,,
placas convencionales,,,,unidad,2006-11-15,salida,placas prestadas de otros trabajos para revista de acreditación,6,494,,
placas convencionales,,,,unidad,2006-11-23,salida,certificados de proyección social,1,493,,
placas convencionales,,,,unidad,2006-11-27,salida,memoria 2004,38,455,,
placas convencionales,,,,unidad,2006-12-06,salida,memoria 2004,3,452,,
placas convencionales,,,,unidad,2006-12-12,salida,memoria 2005,83,369,,
placas convencionales,,,,unidad,2006-12-12,salida,pasta memoria 2005,4,365,,
placas convencionales,,,,unidad,2006-12-13,salida,tarjeta invitación aniversario xlvii,1,364,,
placas convencionales,,,,unidad,2006-12-14,salida,tickets almuerzo aniversario,1,363,,
placas convencionales,,,,unidad,2006-12-15,salida,papeletas de salida biblioteca,1,362,,
placas convencionales,,,,unidad,2006-12-18,salida,para completar memoria 2005,5,357,,
placas convencionales,,,,unidad,2006-12-18,salida,reemplazo de placas defectuosas memoria,4,353,,
placas convencionales,,,,unidad,2006-12-19,salida,caratula memoria 2005,4,349,,
placas convencionales,,,,unidad,2006-12-20,salida,tarjetas navideñas,4,345,,
placas convencionales,,,,unidad,2006-12-21,salida,papeletas de permisos de horas extras,1,344,,
placas convencionales,,,,unidad,2007-01-03,salida,membrete fac. ing. civil e ing. minas,8,336,,
placas convencionales,,,,unidad,2007-01-05,salida,completar memoria 2005,7,329,,
placas convencionales,,,,unidad,2007-01-08,salida,calendario academico 2007-i,1,328,,
placas convencionales,,,,unidad,2007-01-09,salida,memoria 2005,3,325,,
placas convencionales,,,,unidad,2007-01-10,salida,memoria 2005,1,324,,
placas convencionales,,,,unidad,2007-01-23,salida,certificados de proyección social,1,323,,
placas convencionales,,,,unidad,2007-01-24,salida,prospecto de admisión,200,123,,
placas convencionales,,,,unidad,2007-01-27,salida,prospecto de admisión,23,100,,
placas convencionales,,,,unidad,2007-01-28,salida,prospecto de admisión,11,89,,
placas convencionales,,,,unidad,2007-01-29,salida,prospecto de admisión,3,86,,
placas convencionales,,,,unidad,2007-01-30,salida,prospecto de admisión,16,70,,
placas convencionales,,,,unidad,2007-01-31,salida,prospecto de admisión,4,66,,
placas convencionales,,,,unidad,2007-01-31,salida,prospecto de admisión,66,0,,
placas convencionales,,,,unidad,2007-01-31,entrada,o/c admisión 5 cajasx100 - o/c 00016,500,500,,
placas convencionales,,,,unidad,2007-03-07,salida,tarjetas de invitación apertura del año académico,1,499,,
placas convencionales,,,,unidad,2007-03-13,salida,fac. ing. eléctrica modificar datos membrete,1,498,,
placas convencionales,,,,unidad,2007-03-13,salida,transportes control salida vehiculos,1,497,,
placas convencionales,,,,unidad,2007-03-13,salida,escuela post grado adm. certific.,1,496,,
placas convencionales,,,,unidad,2007-03-13,salida,escuela post grado adm. tarjetas,2,494,,
placas convencionales,,,,unidad,2007-04-10,salida,caratula empastado sec. general,1,493,,
placas convencionales,,,,unidad,2007-04-11,salida,caratula empastado sec. general,1,492,,
placas convencionales,,,,unidad,2007-04-23,salida,tickets bienestar universitario (comedor),3,489,,
placas convencionales,,,,unidad,2007-05-11,salida,pasta del plan de funcionamiento 2007,4,485,,
placas convencionales,,,,unidad,2007-05-14,salida,contenido del plan de funcionamiento 2007,85,400,,
placas convencionales,,,,unidad,2007-05-18,salida,plan de funcionamiento 2007,20,380,,
placas convencionales,,,,unidad,2007-05-23,salida,plan de funcionamiento 2007,21,359,,
placas convencionales,,,,unidad,2007-06-04,salida,caratulas de auditoria (uno nuevo),1,358,,
placas convencionales,,,,unidad,2007-06-18,salida,certificado medico,1,357,,
placas convencionales,,,,unidad,2007-06-19,salida,certificado medico,1,356,,
placas convencionales,,,,unidad,2007-06-20,salida,hoja trabajo auditoria,1,355,,
placas convencionales,,,,unidad,2007-06-26,salida,tickets comedor universitario,1,354,,
placas convencionales,,,,unidad,2007-07-09,salida,etiquetas biblioteca,1,353,,
placas convencionales,,,,unidad,2007-07-17,salida,tickets para víveres,6,347,,
placas convencionales,,,,unidad,2007-07-19,salida,mosquitos museo,1,346,,
placas convencionales,,,,unidad,2007-07-23,salida,adicional víveres,1,345,,
placas convencionales,,,,unidad,2007-07-23,salida,post grado biptico industrias alimentarias,4,341,,
placas convencionales,,,,unidad,2007-07-24,salida,post grado biptico industrias alimentarias,1,340,,
placas convencionales,,,,unidad,2007-07-30,salida,bipticos invitaciones y recuerdos museo,8,332,,
placas convencionales,,,,unidad,2007-07-31,salida,bipticos museo,1,331,,
placas convencionales,,,,unidad,2007-08-17,salida,tickets museo,3,328,,
placas convencionales,,,,unidad,2007-08-20,salida,reglamento de asistencia,10,318,,
placas convencionales,,,,unidad,2007-08-20,salida,reglamento de asistencia,1,317,,
placas convencionales,,,,unidad,2007-08-21,salida,tickets museo retira,2,315,,
placas convencionales,,,,unidad,2007-08-21,salida,pastas nuevo reglamento control,4,311,,
placas convencionales,,,,unidad,2007-09-03,salida,solicitud y ficha de inscripción comedor bienestar,3,308,,
placas convencionales,,,,unidad,2007-09-04,salida,ficha informativa sobre soborno,4,304,,
placas convencionales,,,,unidad,2007-09-04,salida,4 placas,4,300,,
placas convencionales,,,,unidad,2007-09-06,salida,7 placas documentos departamento psicología,3,297,,
placas convencionales,,,,unidad,2007-09-07,salida,4 placas para 250 certificados asamblea univ.,8,289,,
placas convencionales,,,,unidad,2007-09-07,salida,4 placas para tarjetas personales autoridades,4,285,,
placas convencionales,,,,unidad,2007-09-10,salida,1 placa para el calendario académico,1,284,,
placas convencionales,,,,unidad,2007-09-19,salida,1 placa registros - cuna,1,283,,
placas convencionales,,,,unidad,2007-10-24,salida,2 placas para examenes fac. metalurgia,2,281,,
placas convencionales,,,,unidad,2007-11-19,salida,1 placa para membrete rectorado (cambiar datos negro),1,280,,
placas convencionales,,,,unidad,2007-11-23,salida,1 placa para membrete de secretaria general,1,279,,
placas convencionales,,,,unidad,2007-11-29,entrada,5 cajas o/c 705 pe 01696,500,779,,
placas convencionales,,,,unidad,2007-12-04,salida,4 placas tripticos sociología,4,775,,
placas convencionales,,,,unidad,2007-12-04,salida,4 placas afiches sociología,4,771,,
placas convencionales,,,,unidad,2007-12-04,salida,2 placas falladas tripticos sociología,2,769,,
placas convencionales,,,,unidad,2007-12-19,salida,4 placas tarjetas navideñas 2007,4,765,,
placas convencionales,,,,unidad,2007-12-19,salida,1 caja + 3 placas para memoria 2006 (salida),103,662,,
placas convencionales,,,,unidad,2007-12-28,salida,1 placa certificados sociologia mesa redonda,1,661,,
placas convencionales,,,,unidad,2007-12-28,salida,2 placas tripticos sociología mesa redonda,2,659,,
placas convencionales,,,,unidad,2007-12-28,salida,1 placa ticket almuerzo aniversario,1,658,,
placas convencionales,,,,unidad,2007-12-28,salida,1 placa folder asesoria legal,1,657,,
placas convencionales,,,,unidad,2008-01-07,salida,8 placas completar memoria 2006,8,649,,
placas convencionales,,,,unidad,2008-02-08,salida,2 placas calendario academico 2008,2,647,,
placas convencionales,,,,unidad,2008-02-14,salida,1 placa membrete zootecnia,1,646,,
placas convencionales,,,,unidad,2008-02-15,salida,1 placa membrete vice rectorado académico,1,645,,
placas convencionales,,,,unidad,2008-02-15,salida,1 placa membrete de asesoria legal,1,644,,
placas convencionales,,,,unidad,2008-02-22,salida,1 placa sobres asesoria legal,1,643,,
placas convencionales,,,,unidad,2008-02-29,salida,1 placa secretaria general membrete,1,642,,
placas convencionales,,,,unidad,2008-03-04,salida,4 placas tarjetas dia de la mujer,4,638,,
placas convencionales,,,,unidad,2008-03-07,salida,2 placas declaracion jurada bienestar,2,636,,
placas convencionales,,,,unidad,2008-03-12,salida,4 placas para declaraciones juradas bienestar,4,632,,
placas convencionales,,,,unidad,2008-03-13,salida,1 placa para tarjeta apertura año academico 2008,1,631,,
placas convencionales,,,,unidad,2008-03-19,salida,4 placas nuevo membrete auditoria,4,627,,
placas convencionales,,,,unidad,2008-03-25,salida,4 placas nuevo certificado de estudio,4,623,,
placas convencionales,,,,unidad,2008-03-26,salida,4 placas calendario apertura año academico 2008 - i,4,619,,
placas convencionales,,,,unidad,2008-03-28,salida,16 placas para membrete res 02195-cj-08,16,603,,
placas convencionales,,,,unidad,2008-04-07,salida,12 placas para membrete rn 02195-cj-08,12,591,,
placas convencionales,,,,unidad,2008-04-08,salida,4 placas membrete fac. zootecnia,4,587,,
placas convencionales,,,,unidad,2008-04-09,salida,4 placas membrete fac. contabilidad,4,583,,
placas convencionales,,,,unidad,2008-04-11,salida,4 placas membrete rectorado,4,579,,
placas convencionales,,,,unidad,2008-04-16,salida,"20 placas membrete agronomía, antrop., arq., cccc forestales",20,559,,
placas convencionales,,,,unidad,2008-04-29,salida,2 placas comedor formato de requerimientos de impresiones,2,557,,
placas convencionales,,,,unidad,2008-04-29,salida,2 placas,2,555,,
placas convencionales,,,,unidad,2008-05-06,salida,4 placas tarjetas día de la madre,4,551,,
placas convencionales,,,,unidad,2008-05-12,salida,4 placas triptico fac. minas aniversario,4,547,,
placas convencionales,,,,unidad,2008-05-16,salida,1 placa fac. sociología certificado practicas,1,546,,
placas convencionales,,,,unidad,2008-05-28,salida,8 placas fac. sistemas,8,538,,
placas convencionales,,,,unidad,2008-06-03,salida,3 placas tickets comedor y kardex,3,535,,
placas convencionales,,,,unidad,2008-06-05,salida,3 placas certificado de estudios antiguo,3,532,,
placas convencionales,,,,unidad,2008-06-11,salida,4 placas tarjeta dia del padre,4,528,,
placas convencionales,,,,unidad,2008-06-16,salida,5 placas membrete asesoria legal,5,523,,
placas convencionales,,,,unidad,2008-06-17,salida,1 placa reemplazar 1 placa membrete de secretaria general,1,522,,
placas convencionales,,,,unidad,2008-06-30,salida,5 placas membrete vice rectorado academico y cuna (registros academicos),5,517,,
placas convencionales,,,,unidad,2008-07-01,salida,1 placa,1,516,,
placas convencionales,,,,unidad,2008-07-07,salida,"16 placas para membrete vice. rec, adm, antrop, arq",16,500,,
placas convencionales,,,,unidad,2008-07-16,salida,"9 placas membrete cs comunicación, enfermeria, medicina",9,491,,
placas convencionales,,,,unidad,2008-07-23,salida,"16 placas membrete trabsc, pphh, tarma, ing. civil",16,475,,
placas convencionales,,,,unidad,2008-07-23,salida,4 placas membretes mecanica,4,471,,
placas convencionales,,,,unidad,2008-07-30,salida,1 placa membrete calendario academico,1,470,,
placas convencionales,,,,unidad,2008-08-07,salida,"5 placas curso taller archivo, tripticos y certificados",5,465,,
placas convencionales,,,,unidad,2008-08-12,salida,2 placas certificado sociologia,2,463,,
placas convencionales,,,,unidad,2008-08-19,salida,2 placas membrete secretaria general,2,461,,
placas convencionales,,,,unidad,2008-08-20,salida,4 placas membrete resoluciones sec. general,4,457,,
placas convencionales,,,,unidad,2008-08-21,salida,2 placas para papeletas de pedido libros biblioteca,2,455,,
placas convencionales,,,,unidad,2008-08-21,salida,1 placa para papeleta de salida de personal,1,454,,
placas convencionales,,,,unidad,2008-09-12,salida,1 placa certificado proyección social docentes,1,453,,
placas convencionales,,,,unidad,2008-09-25,salida,1 placa reemplazar color amarillo,1,452,,
placas convencionales,,,,unidad,2008-09-30,salida,1 placa reemplazar magenta certificado de estudios,1,451,,
placas convencionales,,,,unidad,2008-10-07,salida,1 placa reemplazar negro certificado de estudios,1,450,,
placas convencionales,,,,unidad,2008-10-29,salida,50 placas memoria 2007,50,400,,
placas convencionales,,,,unidad,2008-11-11,salida,100 placas memoria 2007 y plan de funcionamiento 2008,100,300,,
placas convencionales,,,,unidad,2008-11-12,salida,2 placas memoria 2007,2,298,,
placas convencionales,,,,unidad,2008-11-14,salida,4 placas memoria 2007,4,294,,
placas convencionales,,,,unidad,2008-11-19,salida,60 placas plan operativo institucional,60,234,,
placas convencionales,,,,unidad,2008-11-19,salida,34 placas revista investigación,34,200,,
placas convencionales,,,,unidad,2008-12-09,salida,4 placas revista investigación,4,196,,
placas convencionales,,,,unidad,2008-12-09,salida,6 placas tarjetas navideñas,6,190,,
placas convencionales,,,,unidad,2008-12-10,salida,2 placas investigación,2,188,,
placas convencionales,,,,unidad,2008-12-31,salida,4 placas membretado oficina de abastecimientos,4,184,,
placas convencionales,,,,unidad,2009-01-16,salida,2 mosquitos y calendario académico 2009-i,2,182,,
placas convencionales,,,,unidad,2009-02-05,salida,"1 placa rrhh, medica bienestar",1,181,,
placas convencionales,,,,unidad,2009-02-16,salida,1 placa folder asesoria legal,1,180,,
placas convencionales,,,,unidad,2009-02-20,salida,1 placa acta subsanación registros académicos,1,179,,
placas convencionales,,,,unidad,2009-02-26,salida,140 placas membretados,140,39,,
placas convencionales,,,,unidad,2009-03-10,salida,2 placas ficha socioeconómica bienestar,2,37,,
placas convencionales,,,,unidad,2009-03-12,salida,2 placas triptico area sociologia bienestar,2,35,,
placas convencionales,,,,unidad,2009-03-24,salida,1 placa tarjetas inauguración año académico 2009,1,34,,
placas convencionales,,,,unidad,2009-03-24,salida,1 placa tarjetas de impresión inauguración año académico,1,33,,
placas convencionales,,,,unidad,2009-03-25,salida,4 placas membrete oficina,4,29,,
placas convencionales,,,,unidad,2009-04-01,salida,1 placa para membretado asesoria legal,1,28,,
placas convencionales,,,,unidad,2009-04-22,salida,4 placas para tarjetas de secretaria,4,24,,
placas convencionales,,,,unidad,2009-05-12,salida,5 placas certificados estudios post grado,5,19,,
placas convencionales,,,,unidad,2009-05-21,entrada,o/c 0298 500 placas,500,519,,
placas convencionales,,,,unidad,2009-06-04,salida,3 placas hoja evaluación organo control y papeleta de salida,3,516,,
placas convencionales,,,,unidad,2009-06-10,salida,4 placas renovacion placas membrete secretaria general,4,512,,
placas convencionales,,,,unidad,2009-06-15,salida,4 placas para los certificados de proyección social,4,508,,
placas convencionales,,,,unidad,2009-07-08,salida,1 placa folder auditoria,1,507,,
placas convencionales,,,,unidad,2009-07-08,salida,1 placa membrete fac. economía,1,506,,
placas convencionales,,,,unidad,2009-07-13,salida,1 placa calendario académico 2009 - ii,1,505,,
placas convencionales,,,,unidad,2009-07-21,salida,1 placa membrete auditoria,1,504,,
placas convencionales,,,,unidad,2009-07-21,salida,1 placa membrete auditoria,1,503,,
placas convencionales,,,,unidad,2009-08-03,salida,1 placa membrete abastecimientos,1,502,,
placas convencionales,,,,unidad,2009-08-31,salida,1 placa kardex almacen,1,501,,
placas convencionales,,,,unidad,2009-11-09,salida,1 placa triptico comité electoral,1,500,,
placas convencionales,,,,unidad,2009-12-10,salida,1 placa agenda 2010,1,499,,
placas convencionales,,,,unidad,2009-12-17,salida,1 prueba para impresora de placas,1,498,,
placas convencionales,,,,unidad,2009-12-17,salida,1 prueba para impresora de placas,1,497,,
placas convencionales,,,,unidad,2009-12-29,salida,6 interiores de la guia del estudiante,6,491,,
placas convencionales,,,,unidad,2010-01-13,salida,1 certificados fac. sociología,1,490,,
placas convencionales,,,,unidad,2010-01-15,salida,"8 membretes nuevos datos rectorado, vice rectorado",8,482,,
placas convencionales,,,,unidad,2010-01-26,salida,8 formatos y membretes centro medico y auditoria,8,474,,
placas convencionales,,,,unidad,2010-02-03,salida,3 placas membretado sec. general y rrpp y ficha de bienestar,3,471,,
placas convencionales,,,,unidad,2010-02-04,salida,1 placa ficha de bienestar,1,470,,
placas convencionales,,,,unidad,2010-02-12,salida,6 placas guia estudiante,6,464,,
placas convencionales,,,,unidad,2010-03-15,salida,1 placa apertura año académico,1,463,,
placas convencionales,,,,unidad,2010-03-25,salida,1 placa membrete fac. ing. industrias,1,462,,
placas convencionales,,,,unidad,2010-04-07,salida,"trabajos bienestar centro medico, planta huari, transportes",12,450,,
placas convencionales,,,,unidad,2010-04-07,salida,papeleta de salida oficina de empleo y desarrollo,1,449,,
placas convencionales,,,,unidad,2010-04-08,salida,planta yauris formatos,2,447,,
placas convencionales,,,,unidad,2010-04-15,salida,censo universitario,1,446,,
placas convencionales,,,,unidad,2010-04-19,salida,4 membretes oficina general de mantenimiento y fac. enfermeria,4,442,,
placas convencionales,,,,unidad,2010-04-23,salida,5 tarjetas dia de la secretaria y psicologia y correcion censo,5,437,,
placas convencionales,,,,unidad,2010-04-28,salida,4 placas membretado fac. economia,4,433,,
placas convencionales,,,,unidad,2010-04-29,salida,1 placa tarjetas dia del trabajo,1,432,,
placas convencionales,,,,unidad,2010-05-06,salida,5 placas tarjetas dia de la madre y membrete proyección social,5,427,,
placas convencionales,,,,unidad,2010-05-21,salida,2 placas triptico cengap,2,425,,
placas convencionales,,,,unidad,2010-06-01,salida,"9 placas concap, centro medico, membre v. acad.",9,416,,
placas convencionales,,,,unidad,2010-06-03,salida,4 placas certificados de estudios,4,412,,
placas convencionales,,,,unidad,2010-06-04,salida,1 placa membrete vice. rec. acad.,1,411,,
placas convencionales,,,,unidad,2010-06-08,salida,1 placa facultad zootecnia,1,410,,
placas convencionales,,,,unidad,2010-06-18,salida,5 placas tarjetas dia del padre,5,405,,
placas convencionales,,,,unidad,2010-06-23,salida,3 placas pruebas con ctp inkjet mantenimiento,3,402,,
placas convencionales,,,,unidad,2010-07-22,salida,1 placa sec. general membrete,1,401,,
placas convencionales,,,,unidad,2010-08-03,salida,5 placas bienestar universitario,5,396,,
placas convencionales,,,,unidad,2010-08-25,salida,2 placas hojas tramite documentario,2,394,,
placas convencionales,,,,unidad,2010-09-03,salida,1 placa membrete tramite documentario,1,393,,
placas convencionales,,,,unidad,2010-10-15,salida,4 placas membrete fac. zootecnia,4,389,,
placas convencionales,,,,unidad,2010-11-15,salida,2 pruebas calibración impresora fotolitos,2,387,,
placas convencionales,,,,unidad,2011-01-05,salida,1 membrete fac. trabajo social,1,386,,
placas convencionales,,,,unidad,2011-01-14,salida,2 cuna registros académicos,2,384,,
placas convencionales,,,,unidad,2011-01-26,salida,1 membrete trámite documentario,1,383,,
placas convencionales,,,,unidad,2011-01-28,salida,1 membrete trámite documentario,1,382,,
placas convencionales,,,,unidad,2011-02-04,salida,2 membretes facultad enfermería y contabilidad cambio de datos,2,380,,
placas convencionales,,,,unidad,2011-02-04,salida,1 membrete facultad mec.,1,379,,
placas convencionales,,,,unidad,2011-02-17,salida,1 placa membrete sec. general,1,378,,
placas convencionales,,,,unidad,2011-03-21,salida,1 placa membrete fac. administración,1,377,,
placas convencionales,,,,unidad,2011-04-01,salida,1 placa ctp mantenimiento,1,376,,
placas convencionales,,,,unidad,2011-04-07,salida,1 placa ctp mantenimiento,1,375,,
placas convencionales,,,,unidad,2011-04-15,salida,4 fac. forestales membrete encuesta personal,4,371,,
placas convencionales,,,,unidad,2011-06-10,salida,1 papeleta de pedido de libros y otros biblioteca,1,370,,
placas convencionales,,,,unidad,2011-06-28,salida,1 formato sociología,1,369,,
placas convencionales,,,,unidad,2011-06-28,salida,1 formato sociología,1,368,,
placas convencionales,,,,unidad,2011-09-09,salida,1 certificados enfermería,1,367,,
placas convencionales,,,,unidad,2011-09-25,salida,1 corrección dirección membrete proyección social,1,366,,
placas convencionales,,,,unidad,2011-09-19,salida,1 corregir dirección membrete ing. civil,1,365,,
placas convencionales,,,,unidad,2011-10-10,salida,1 placa papeleta de salida,1,364,,
placas convencionales,,,,unidad,2011-10-12,salida,formato de cuna,1,363,,
placas convencionales,,,,unidad,2011-10-14,salida,membrete de metalurgia y de quimica,2,361,,
placas convencionales,,,,unidad,2011-10-28,salida,3 placas,3,358,,
placas convencionales,,,,unidad,2011-11-21,salida,cedulas comité electoral,1,357,,
placas convencionales,,,,unidad,2011-12-05,salida,placa folderes de auditoria,1,356,,
placas convencionales,,,,unidad,2011-12-07,salida,1 placa,1,355,,
placas convencionales,,,,unidad,2011-12-13,salida,3 placas invitaciones ceremonia aniversario,5,350,,
plate cleaner k limpiador y activador de placas (litho emulsion),HOSTMANN,,,litros,2005-09-14,entrada,o/c 907,100,100,,
plate cleaner k limpiador y activador de placas (litho emulsion),HOSTMANN,,,litros,2005-11-03,salida,,1,99,,
plate cleaner k limpiador y activador de placas (litho emulsion),HOSTMANN,,,litros,2005-11-21,salida,,1,98,,
plate cleaner k limpiador y activador de placas (litho emulsion),HOSTMANN,,,litros,2006-01-03,salida,,1,97,,
plate cleaner k limpiador y activador de placas (litho emulsion),HOSTMANN,,,litros,2006-06-27,salida,,1,96,,
plate cleaner k limpiador y activador de placas (litho emulsion),HOSTMANN,,,litros,2006-07-24,salida,,1,95,,
plate cleaner k limpiador y activador de placas (litho emulsion),HOSTMANN,,,litros,2006-08-07,salida,,1,94,,
plate cleaner k limpiador y activador de placas (litho emulsion),HOSTMANN,,,litros,2006-09-13,salida,,1,93,,
plate cleaner k limpiador y activador de placas (litho emulsion),HOSTMANN,,,litros,2006-09-25,salida,,1,92,,
plate cleaner k limpiador y activador de placas (litho emulsion),HOSTMANN,,,litros,2006-10-02,salida,,1,91,,
plate cleaner k limpiador y activador de placas (litho emulsion),HOSTMANN,,,litros,2006-11-10,salida,,1,90,,
plate cleaner k limpiador y activador de placas (litho emulsion),HOSTMANN,,,litros,2007-01-03,salida,,1,89,,
plate cleaner k limpiador y activador de placas (litho emulsion),HOSTMANN,,,litros,2007-01-24,salida,,1,88,,
plate cleaner k limpiador y activador de placas (litho emulsion),HOSTMANN,,,litros,2007-01-28,salida,,1,87,,
plate cleaner k limpiador y activador de placas (litho emulsion),HOSTMANN,,,litros,2007-02-01,salida,,1,86,,
plate cleaner k limpiador y activador de placas (litho emulsion),HOSTMANN,,,litros,2007-04-02,salida,,1,85,,
plate cleaner k limpiador y activador de placas (litho emulsion),HOSTMANN,,,litros,2007-05-18,salida,,1,84,,
plate cleaner k limpiador y activador de placas (litho emulsion),HOSTMANN,,,litros,2007-07-10,salida,,1,83,,
plate cleaner k limpiador y activador de placas (litho emulsion),HOSTMANN,,,litros,2007-09-11,salida,,1,82,,
plate cleaner k limpiador y activador de placas (litho emulsion),HOSTMANN,,,litros,2007-11-23,salida,,1,81,,
plate cleaner k limpiador y activador de placas (litho emulsion),HOSTMANN,,,litros,2008-04-07,salida,,1,80,,
plate cleaner k limpiador y activador de placas (litho emulsion),HOSTMANN,,,litros,2008-06-06,salida,,1,79,,
plate cleaner k limpiador y activador de placas (litho emulsion),HOSTMANN,,,litros,2008-08-01,salida,,1,78,,
plate cleaner k limpiador y activador de placas (litho emulsion),HOSTMANN,,,litros,2008-09-16,salida,,1,77,,
plate cleaner k limpiador y activador de placas (litho emulsion),HOSTMANN,,,litros,2008-12-05,salida,,1,76,,
plate cleaner k limpiador y activador de placas (litho emulsion),HOSTMANN,,,litros,2008-12-23,salida,,1,75,,
plate cleaner k limpiador y activador de placas (litho emulsion),HOSTMANN,,,litros,2009-02-05,salida,,1,74,,
plate cleaner k limpiador y activador de placas (litho emulsion),HOSTMANN,,,litros,2009-03-25,salida,,1,73,,
plate cleaner k limpiador y activador de placas (litho emulsion),HOSTMANN,,,litros,2009-04-08,salida,,1,72,,
plate cleaner k limpiador y activador de placas (litho emulsion),HOSTMANN,,,litros,2009-04-21,salida,,1,71,,
plate cleaner k limpiador y activador de placas (litho emulsion),HOSTMANN,,,litros,2009-06-10,salida,,1,70,,
plate cleaner k limpiador y activador de placas (litho emulsion),HOSTMANN,,,litros,2009-07-03,salida,,1,69,,
plate cleaner k limpiador y activador de placas (litho emulsion),HOSTMANN,,,litros,2009-07-24,salida,,1,68,,
plate cleaner k limpiador y activador de placas (litho emulsion),HOSTMANN,,,litros,2009-08-28,salida,,1,67,,
plate cleaner k limpiador y activador de placas (litho emulsion),HOSTMANN,,,litros,2009-09-03,salida,,1,66,,
plate cleaner k limpiador y activador de placas (litho emulsion),HOSTMANN,,,litros,2009-09-15,salida,,1,65,,
plate cleaner k limpiador y activador de placas (litho emulsion),HOSTMANN,,,litros,2009-09-23,salida,,1,64,,
plate cleaner k limpiador y activador de placas (litho emulsion),HOSTMANN,,,litros,2009-10-02,salida,,1,63,,
plate cleaner k limpiador y activador de placas (litho emulsion),HOSTMANN,,,litros,2009-10-12,salida,,1,62,,
plate cleaner k limpiador y activador de placas (litho emulsion),HOSTMANN,,,litros,2009-10-14,salida,,1,61,,
plate cleaner k limpiador y activador de placas (litho emulsion),HOSTMANN,,,litros,2009-12-07,salida,,1,60,,
plate cleaner k limpiador y activador de placas (litho emulsion),HOSTMANN,,,litros,2009-12-30,salida,,1,59,,
plate cleaner k limpiador y activador de placas (litho emulsion),HOSTMANN,,,litros,2010-01-22,salida,,1,58,,
plate cleaner k limpiador y activador de placas (litho emulsion),HOSTMANN,,,litros,2010-02-16,salida,,1,57,,
plate cleaner k limpiador y activador de placas (litho emulsion),HOSTMANN,,,litros,2010-03-01,salida,,1,56,,
plate cleaner k limpiador y activador de placas (litho emulsion),HOSTMANN,,,litros,2010-04-05,salida,,1,55,,
plate cleaner k limpiador y activador de placas (litho emulsion),HOSTMANN,,,litros,2010-04-14,salida,,1,54,,
plate cleaner k limpiador y activador de placas (litho emulsion),HOSTMANN,,,litros,2010-05-26,salida,,1,53,,
plate cleaner k limpiador y activador de placas (litho emulsion),HOSTMANN,,,litros,2010-06-04,salida,,1,52,,
plate cleaner k limpiador y activador de placas (litho emulsion),HOSTMANN,,,litros,2010-07-13,salida,,1,51,,
plate cleaner k limpiador y activador de placas (litho emulsion),HOSTMANN,,,litros,2010-08-16,salida,,1,50,,
plate cleaner k limpiador y activador de placas (litho emulsion),HOSTMANN,,,litros,2010-08-26,salida,,1,49,,
plate cleaner k limpiador y activador de placas (litho emulsion),HOSTMANN,,,litros,2010-09-02,salida,,1,48,,
plate cleaner k limpiador y activador de placas (litho emulsion),HOSTMANN,,,litros,2010-09-15,salida,,1,47,,
plate cleaner k limpiador y activador de placas (litho emulsion),HOSTMANN,,,litros,2010-10-27,salida,,1,46,,
plate cleaner k limpiador y activador de placas (litho emulsion),HOSTMANN,,,litros,2010-11-02,salida,,1,45,,
plate cleaner k limpiador y activador de placas (litho emulsion),HOSTMANN,,,litros,2011-01-26,salida,,1,44,,
plate cleaner k limpiador y activador de placas (litho emulsion),HOSTMANN,,,litros,2011-02-15,salida,,1,43,,
plate cleaner k limpiador y activador de placas (litho emulsion),HOSTMANN,,,litros,2011-02-21,salida,,1,42,,
plate cleaner k limpiador y activador de placas (litho emulsion),HOSTMANN,,,litros,2011-05-06,salida,,1,41,,
plate cleaner k limpiador y activador de placas (litho emulsion),HOSTMANN,,,litros,2011-08-16,salida,,1,40,,
plate cleaner k limpiador y activador de placas (litho emulsion),HOSTMANN,,,litros,2011-10-05,salida,,1,39,,
percalina,,,,metros,2007-09-17,entrada,o/c 676,250,250,,
percalina,,,,metros,2009-11-16,salida,trabajos de empastados a las 200 diferentes facultades y oficinas por registro de producción,200,50,,
percalina,,,,metros,2009-11-17,entrada,,700,750,,
polvo antirepinte,HOSTMANN,,,kilos,2006-06-02,entrada,o/c 982,3,3,,
polvo antirepinte,HOSTMANN,,,kilos,2005-11-03,entrada,obsequio de heidelberg 0.750 gramos,0.75,3.75,,
polvo antirepinte,HOSTMANN,,,kilos,2006-09-26,salida,,0.25,3.5,,
revelador de placas,,44515215,,galón,2004-12-30,entrada,o/c 1029 - pe 01461,1,1,,
revelador de placas,,44515215,,galón,2005-03-10,salida,,1,0,,
revelador de placas,,44515215,,galón,2005-05-17,entrada,o/c 197,3,3,,
revelador de placas,,44515215,,galón,2005-11-03,salida,,1,2,,
revelador de placas,,44515215,,galón,2006-09-13,salida,,0.5,1.5,,
revelador de placas,,44515215,,galón,2006-09-21,salida,,0.25,1.25,,
revelador de placas,,44515215,,galón,2006-12-01,salida,,0.25,1,,
revelador de placas,,44515215,,galón,2006-12-14,salida,,0.25,0.75,,
revelador de placas,,44515215,,galón,2006-12-15,salida,,0.25,0.5,,
revelador de placas,,44515215,,galón,2007-01-08,salida,,0.25,0.25,,
revelador de placas,,44515215,,galón,2007-01-24,salida,,0.25,0,,
revelador de placas,,44515215,,galón,2007-02-28,entrada,o/c 00016,2,2,,
revelador de placas,,44515215,,galón,2007-02-28,salida,,1,1,,
revelador de placas,,44515215,,galón,2007-05-18,salida,,0.25,0.75,,
revelador de placas,,44515215,,galón,2007-07-23,salida,,0.25,0.5,,
revelador de placas,,44515215,,galón,2007-08-20,salida,,0.25,0.25,,
revelador de placas,,44515215,,galón,2007-09-06,salida,,0.1,0.15,,
revelador de placas,,44515215,,galón,2007-11-27,entrada,o/c 523,3,3.15,,
revelador de placas,,44515215,,galón,2007-12-01,salida,tripticos sociologia,0.05,3.1,,
revelador de placas,,44515215,,galón,2007-12-10,salida,memoria 2006,0.1,3,,
revelador de placas,,44515215,,galón,2008-03-12,salida,,0.1,2.9,,
revelador de placas,,44515215,,galón,2008-03-31,salida,,0.1,2.8,,
revelador de placas,,44515215,,galón,2008-04-07,salida,,0.1,2.7,,
revelador de placas,,44515215,,galón,2008-04-15,salida,,0.1,2.6,,
revelador de placas,,44515215,,galón,2008-05-21,salida,,0.1,2.5,,
revelador de placas,,44515215,,galón,2008-06-16,salida,,0.1,2.4,,
revelador de placas,,44515215,,galón,2008-07-24,salida,,0.1,2.3,,
revelador de placas,,44515215,,galón,2008-08-13,salida,,0.1,2.2,,
revelador de placas,,44515215,,galón,2008-08-21,salida,,0.1,2.1,,
revelador de placas,,44515215,,galón,2008-11-10,salida,,0.05,2.05,,
revelador de placas,,44515215,,galón,2008-12-09,salida,,0.05,2,,
revelador de placas,,44515215,,galón,2009-08-03,salida,,1,1,,
revelador de placas,,44515215,,galón,2010-04-20,salida,,1,0,,
revelador de placas,,44515215,,galón,2010-10-20,entrada,pe 01757 40 litros,40,40,36,180
revelador de placas,,44515215,,galón,2011-05-10,salida,,4,36,,
revelador de placas,,44515215,,galón,2011-10-10,salida,,4,32,,
solución de fuente direct fluia,HOSTMANN,,,bidón x 10 kilos,2006-06-02,entrada,,10,10,,
solución de fuente direct fluia,HOSTMANN,,,bidón x 10 kilos,2006-11-03,entrada,o/c 982,1,9,,
solución de fuente direct fluia,HOSTMANN,,,bidón x 10 kilos,2005-12-15,salida,,2,7,,
solución de fuente direct fluia,HOSTMANN,,,bidón x 10 kilos,2006-05-16,salida,,2,5,,
solución de fuente direct fluia,HOSTMANN,,,bidón x 10 kilos,2006-06-01,salida,,2,3,,
solución de fuente direct fluia,HOSTMANN,,,bidón x 10 kilos,2007-01-18,salida,,1,2,,
solución de fuente direct fluia,HOSTMANN,,,bidón x 10 kilos,2007-01-24,salida,,0.5,1.5,,
solución de fuente direct fluia,HOSTMANN,,,bidón x 10 kilos,2007-01-27,salida,,1,0.5,,
solución de fuente direct fluia,HOSTMANN,,,bidón x 10 kilos,2007-02-20,salida,,0.25,0.25,,
solución de fuente direct fluia,HOSTMANN,,,bidón x 10 kilos,2007-07-26,entrada,o/c 00527,10,10.25,,
solución de fuente direct fluia,HOSTMANN,,,bidón x 10 kilos,2008-01-04,salida,,0.25,10,,
solución de fuente direct fluia,HOSTMANN,,,bidón x 10 kilos,2008-02-18,salida,,0.35,9.65,,
solución de fuente direct fluia,HOSTMANN,,,bidón x 10 kilos,2008-03-25,salida,,0.35,9.3,,
solución de fuente direct fluia,HOSTMANN,,,bidón x 10 kilos,2008-04-18,salida,,0.45,8.85,,
solución de fuente direct fluia,HOSTMANN,,,bidón x 10 kilos,2008-05-29,entrada,o/c 00331,20,28.85,,
solución de fuente direct fluia,HOSTMANN,,,bidón x 10 kilos,2008-06-02,salida,,1.05,27.8,,
solución de fuente direct fluia,HOSTMANN,,,bidón x 10 kilos,2008-07-08,salida,,0.3,27.5,,
solución de fuente direct fluia,HOSTMANN,,,bidón x 10 kilos,2008-07-21,salida,,0.3,27.2,,
solución de fuente direct fluia,HOSTMANN,,,bidón x 10 kilos,2008-08-13,salida,,0.7,26.5,,
solución de fuente direct fluia,HOSTMANN,,,bidón x 10 kilos,2008-08-26,salida,,0.3,26.2,,
solución de fuente direct fluia,HOSTMANN,,,bidón x 10 kilos,2008-11-06,salida,,0.3,25.9,,
solución de fuente direct fluia,HOSTMANN,,,bidón x 10 kilos,2008-12-01,salida,,0.9,25,,
solución de fuente direct fluia,HOSTMANN,,,bidón x 10 kilos,2008-12-11,salida,,0.1,24.9,,
solución de fuente direct fluia,HOSTMANN,,,bidón x 10 kilos,2009-02-02,salida,,0.5,24.4,,
solución de fuente direct fluia,HOSTMANN,,,bidón x 10 kilos,2009-07-20,salida,,0.5,23.9,,
solución de fuente direct fluia,HOSTMANN,,,bidón x 10 kilos,2009-08-25,salida,,1.5,22.4,,
solución de fuente direct fluia,HOSTMANN,,,bidón x 10 kilos,2009-08-27,salida,,0.4,22,,
solución de fuente direct fluia,HOSTMANN,,,bidón x 10 kilos,2009-09-02,salida,,2,20,,
solución de fuente direct fluia,HOSTMANN,,,bidón x 10 kilos,2009-11-02,salida,,0.75,19.25,,
solución de fuente direct fluia,HOSTMANN,,,bidón x 10 kilos,2009-12-17,salida,,0.75,18.5,,
solución de fuente direct fluia,HOSTMANN,,,bidón x 10 kilos,2010-02-12,salida,,0.86,17.64,,
solución de fuente direct fluia,HOSTMANN,,,bidón x 10 kilos,2010-03-25,salida,,0.9,16.74,,
solución de fuente direct fluia,HOSTMANN,,,bidón x 10 kilos,2010-06-01,salida,,0.9,15.84,,
solución de fuente direct fluia,HOSTMANN,,,bidón x 10 kilos,2010-07-14,salida,,0.9,14.94,,
solución de fuente direct fluia,HOSTMANN,,,bidón x 10 kilos,2010-08-16,salida,,1,13.94,,
solución de fuente direct fluia,HOSTMANN,,,bidón x 10 kilos,2010-10-18,salida,,1.25,12.69,,
solución de fuente direct fluia,HOSTMANN,,,bidón x 10 kilos,2010-10-28,entrada,pe 01757 20 litros,20,32.69,7.5,150
solución de fuente direct fluia,HOSTMANN,,,bidón x 10 kilos,2010-11-16,salida,cambio total recirculado,5.2,27.49,,
solución de fuente direct fluia,HOSTMANN,,,bidón x 10 kilos,2011-01-05,salida,4 litros mas 490 mililitros,4.49,23,,
solución de fuente direct fluia,HOSTMANN,,,bidón x 10 kilos,2011-07-18,salida,4 litros mas 750 mililitros,4.75,18.25,,
solución de fuente direct fluia,HOSTMANN,,,bidón x 10 kilos,2011-10-17,salida,1 litro,1,17.25,,
solución de fuente direct fluia,HOSTMANN,,,bidón x 10 kilos,2011-12-07,salida,4 litros,4,13.25,,
trapo industrial color,,,color,kilogramos,2004-12-30,entrada,o/c 983 - pe 01452,50,50,,
trapo industrial color,,,color,kilogramos,2005-03-10,salida,,3,47,,
trapo industrial color,,,color,kilogramos,2005-11-03,salida,,4,43,,
trapo industrial color,,,color,kilogramos,2006-01-02,salida,,3,40,,
trapo industrial color,,,color,kilogramos,2006-05-12,salida,,1,39,,
trapo industrial color,,,color,kilogramos,2006-08-03,salida,,1,38,,
trapo industrial color,,,color,kilogramos,2006-08-23,salida,,1,37,,
trapo industrial color,,,color,kilogramos,2006-09-21,salida,,1,36,,
trapo industrial color,,,color,kilogramos,2006-12-13,salida,,1,35,,
trapo industrial color,,,color,kilogramos,2007-01-18,salida,,1,34,,
trapo industrial color,,,color,kilogramos,2007-01-24,salida,,3,31,,
trapo industrial color,,,color,kilogramos,2007-05-15,salida,,4,27,,
trapo industrial color,,,color,kilogramos,2007-07-27,salida,,3,24,,
trapo industrial color,,,color,kilogramos,2007-08-09,salida,,3,21,,
trapo industrial color,,,color,kilogramos,2007-10-02,salida,,2,19,,
trapo industrial color,,,color,kilogramos,2008-04-14,salida,,2,17,,
trapo industrial color,,,color,kilogramos,2008-06-11,salida,,1,16,,
trapo industrial color,,,color,kilogramos,2008-09-16,salida,,1,15,,
trapo industrial color,,,color,kilogramos,2008-12-05,salida,,1,14,,
trapo industrial color,,,color,kilogramos,2009-01-21,salida,,1,13,,
trapo industrial color,,,color,kilogramos,2009-06-01,salida,,3,10,,
trapo industrial color,,,color,kilogramos,2009-12-04,salida,,2,8,,
trapo industrial color,,,color,kilogramos,2010-03-23,salida,,1,7,,
trapo industrial color,,,color,kilogramos,2010-06-10,salida,,1,6,,
trapo industrial color,,,color,kilogramos,2010-08-13,salida,,1,5,,
trapo industrial color,,,color,kilogramos,2011-01-02,salida,,2,3,,
trapo industrial color,,,color,kilogramos,2011-06-09,salida,,2,1,,
trapo industrial color,,,color,kilogramos,2011-08-26,entrada,pe 01103 - 40 kilogramos de color,40,41,3.5,140
trapo industrial blanco,,,blanco,kilogramos,2011-08-26,entrada,pe 01103 - 8 kilogramos blanco,8,8,4.5,36
tinta especial color reflejo azul,,44515209,,lata x kg,2004-12-30,entrada,o/c 1024 - peo1461 saldo al 3/11/2005,1,1,,
tinta blanco opaco,FLINTINK,44515204,,lata x kg,2004-11-19,entrada,o/c 981 - pe 01197,8,8,,
tinta blanco opaco,FLINTINK,44515204,,lata x kg,2005-03-10,salida,,2,6,,
tinta blanco opaco,FLINTINK,44515204,,lata x kg,2005-11-03,entrada,se encontró en uso 1,1,7,,
tinta blanco opaco,FLINTINK,44515204,,lata x kg,2008-03-14,salida,,1,6,,
tinta blanco transparente,HOSTMANN,,,kilogramos,2005-05-17,entrada,o/c 197,4,4,,
tinta blanco transparente,HOSTMANN,,,kilogramos,2010-04-06,salida,,1,3,,
tinta blanco transparente,HOSTMANN,,,kilogramos,2011-07-11,salida,,1,2,,
tinta blanco transparente sin secante,GRAPEX,,,2k,2005-11-08,entrada,1 sobrante encontrado al arreglar la oficina de publicaciones,1,1,,
tinta blanco transparente sin secante,GRAPEX,,,2k,2006-02-20,entrada,se encontró 2,2,3,,
tinta blanco transparente sin secante,GRAPEX,,,2k,2006-12-04,salida,,1,2,,
tinta blanco transparente sin secante,GRAPEX,,,2k,2010-04-06,salida,,1,1,,
tinta china,PELIKAN,,,frasquitos,2007-01-31,entrada,,101,101,,
tinta china,PELIKAN,,,frasquitos,2007-01-31,salida,,17,84,,
tinta china,PELIKAN,,,frasquitos,2009-09-24,salida,,19,65,,
tinta china,PELIKAN,,,frasquitos,2010-04-06,salida,,5,60,,
tinta magenta (selección),,,,kilogramo (2.5kg x lata),2005-05-17,entrada,o/c 197,6,6,,
tinta magenta (selección),,,,kilogramo (2.5kg x lata),2005-11-03,salida,,1,5,,
tinta magenta (selección),,,,kilogramo (2.5kg x lata),2007-01-25,salida,,1,4,,
tinta magenta (selección),,,,kilogramo (2.5kg x lata),2008-11-06,salida,,1,3,,
tinta magenta (selección),,,,kilogramo (2.5kg x lata),2010-05-05,salida,,1,2,,
tinta magenta (selección),,,,kilogramo (2.5kg x lata),2011-10-12,salida,,1,1,,
tinta negro (selección),HOSTMANN,,,kilogramo (2.5kg x lata),2005-05-17,entrada,o/c 197,6,6,,
tinta negro (selección),HOSTMANN,,,kilogramo (2.5kg x lata),2005-11-03,salida,,1,5,,
tinta negro (selección),HOSTMANN,,,kilogramo (2.5kg x lata),2007-01-31,salida,,1,4,,
tinta negro (selección),HOSTMANN,,,kilogramo (2.5kg x lata),2008-09-26,salida,,1,3,,
tinta negro (selección),HOSTMANN,,,kilogramo (2.5kg x lata),2010-06-04,salida,,1,2,,
tinta negro (selección),HOSTMANN,,,kilogramo (2.5kg x lata),2011-09-08,salida,,1,1,,
tinta negra bond,IMAGEN BANDSON,,,,2005-03-10,entrada,o/c 982,8,8,,
tinta negra bond,IMAGEN BANDSON,,,,2005-11-03,salida,,1,7,,
tinta negra bond,IMAGEN BANDSON,,,,2006-08-07,salida,,2,5,,
tinta negra bond,IMAGEN BANDSON,,,,2007-12-11,salida,,1,4,,
tinta negra bond,IMAGEN BANDSON,,,,2010-04-06,salida,,1,3,,
tinta negra bond,IMAGEN BANDSON,,,,2010-04-19,salida,,1,2,,
tinta alpha negro bond,HOSTMANN,,,kilogramo,2005-05-17,entrada,o/c 197,5,5,,
tinta alpha negro bond,HOSTMANN,,,kilogramo,2006-05-16,salida,,1,4,,
tinta alpha negro bond,HOSTMANN,,,kilogramo,2006-09-18,salida,,1,3,,
tinta alpha negro bond,HOSTMANN,,,kilogramo,2007-11-23,salida,,1,2,,
tinta saphira to2 black,,,black,lata x 2.5 kg,2011-09-26,entrada,,2,2,90,180
tinta saphira to2 yellow,,,yellow,lata x 2.5 kg,2011-09-26,entrada,,2,2,90,180
tinta saphira to2 cyan,,,cyan,lata x 2.5 kg,2011-09-26,entrada,,2,2,90,180
tinta saphira to2 cyan,,,cyan,lata x 2.5 kg,2011-12-14,salida,,1,1,,
tinta saphira to2 magenta,,,magenta,lata x 2.5 kg,2011-09-26,entrada,,2,2,90,180
toner gpr 20 black,,,black,,2010-08-25,entrada,,6,6,310,1860
toner gpr 20 black,,,black,,2010-08-27,salida,,1,5,,
toner gpr 20 black,,,black,,2010-10-18,salida,,1,4,,
toner gpr 20 black,,,black,,2011-08-11,salida,,1,3,,
toner gpr 20 black,,,black,,2011-10-27,salida,,1,2,,
toner gpr 20 black,,,black,,2011-11-21,salida,,1,1,,
toner gpr 20 black,,,black,,2011-12-12,salida,,1,0,,
toner gpr 20 cyan,,,cyan,,2010-08-25,entrada,,4,4,530,2120
toner gpr 20 cyan,,,cyan,,2010-12-14,salida,,1,3,,
toner gpr 20 cyan,,,cyan,,2011-10-12,salida,,1,2,,
toner gpr 20 cyan,,,cyan,,2011-12-14,salida,,1,1,,
toner gpr 20 magenta,,,magenta,,2010-08-25,entrada,,4,4,530,2120
toner gpr 20 magenta,,,magenta,,2011-10-12,salida,,1,3,,
toner gpr 20 yellow,,,yellow,,2010-08-25,entrada,,6,6,530,3180
toner gpr 20 yellow,,,yellow,,2011-08-11,salida,,1,5,,
toner gpr 20 yellow,,,yellow,,2011-10-17,salida,,1,4,,
toner gpr 20 yellow,,,yellow,,2011-11-09,salida,,1,3,,
