Artículo,Marca,Código,Característica,Unidad de medida,Fecha,Tipo,Detalle,Cantidad,Saldo,Precio unitario,Precio total
Bobinas de anillo doble ring,TNIN RING WIRE,,,bobina,2007-10-15,entrada,O/C 650,4,4,,
Cartulina folcote calibre 10,,,,resma 70x100x100 - 1R = 100 hojas,2005-12-09,entrada,O/C 522,1000,1000,,
Cartulina folcote calibre 10,,,,resma 70x100x100 - 1R = 100 hojas,2006-09-01,salida,oficio 151-2006-JCM/UNCP,60,940,,
Cartulina folcote calibre 10,,,,resma 70x100x100 - 1R = 100 hojas,2007-09-05,salida,historias clinicas y kardex,200,740,,
Cartulina folcote calibre 10,,,,resma 70x100x100 - 1R = 100 hojas,2009-04-06,salida,kardex centro medico,100,640,,
Cartulina folcote calibre 10,,,,resma 70x100x100 - 1R = 100 hojas,2009-06-10,salida,tarjeta invitación aulas virtuales,40,600,,
Cartulina folcote calibre 10,,,,resma 70x100x100 - 1R = 100 hojas,2009-11-26,salida,comisión organizadora 50 años carnets deportivos,100,500,,
Cartulina folcote calibre 10,,,,resma 70x100x100 - 1R = 100 hojas,2010-03-29,salida,1 resma pastas plan operativo y memoria 2008,100,400,,
Cartulina folcote calibre 10,,,,resma 70x100x100 - 1R = 100 hojas,2010-05-07,salida,27 hojas caratula prospecto 2010 medicina,27,373,,
Cartulina folcote calibre 10,,,,resma 70x100x100 - 1R = 100 hojas,2010-09-30,salida,6 hojas caratula plan estrategico planif. 2010,6,367,,
Cartulina folcote calibre 10,,,,resma 70x100x100 - 1R = 100 hojas,2010-12-05,salida,hojas invitaciones aniversario,69,298,,
Cartulina folcote calibre 10,,,,resma 70x100x100 - 1R = 100 hojas,2010-12-07,salida,70 hojas invitaciones aniversario,70,228,,
Cartulina folcote calibre 10,,,,resma 70x100x100 - 1R = 100 hojas,2010-12-07,entrada,restante desglosado = 4 paquetes x 100 hojas,172,400,,
Cartulina folcote calibre 10,,,,resma 70x100x100 - 1R = 100 hojas,2011-07-27,entrada,5 resmas x 100 hojas PE00806,500,900,75.36,376.8
Cartulina folcote calibre 10,,,,resma 70x100x100 - 1R = 100 hojas,2011-08-25,salida,50 hojas ceritificados evento convenio fac. enfermería,50,850,,
Cartulina folcote calibre 10,,,,resma 70x100x100 - 1R = 100 hojas,2011-09-19,salida,42 hojas folder registros académicos,42,808,,
Cartulina folcote calibre 10,,,,resma 70x100x100 - 1R = 100 hojas,2011-09-19,salida,8 hojas folder registros académicos,8,800,,
Cartulina folcote calibre 10,,,,resma 70x100x100 - 1R = 100 hojas,2011-10-10,salida,empastado de actas de archivo central,3,797,,
Cartulina folcote calibre 10,,,,resma 70x100x100 - 1R = 100 hojas,2011-10-11,salida,5 hojas certificado de proyección social,5,792,,
Cartulina folcote calibre 10,,,,resma 70x100x100 - 1R = 100 hojas,2011-10-12,salida,taller LIBUM UNCP,10,782,,
Cartulina folcote calibre 10,,,,resma 70x100x100 - 1R = 100 hojas,2011-10-13,salida,30 hojas de vicerrectorado academico,30,752,,
Cartulina folcote calibre 10,,,,resma 70x100x100 - 1R = 100 hojas,2011-10-28,salida,29 pliegos,29,723,,
Cartulina folcote calibre 10,,,,resma 70x100x100 - 1R = 100 hojas,2011-11-30,salida,12 pliegos libros de secretaria general,12,711,,
Cartulina folcote calibre 10,,,,resma 70x100x100 - 1R = 100 hojas,2011-12-29,salida,10 pliegos secretaria general,10,701,,
Cartulina folcote calibre 10,,,,resma 70x100x100 - 1R = 100 hojas,2011-12-30,salida,5 pliegos secretaria general,5,696,,
Cartón nº 8 de 1.00 x 0.70,,,,pliego,2009-06-09,entrada,O/C 465,300,300,,
Cartón nº 8 de 1.00 x 0.70,,,,pliego,2009-06-17,salida,14 planchas empastadas auditoria,14,286,,
Cartón nº 8 de 1.00 x 0.70,,,,pliego,2009-07-07,salida,7 cartones membretados fac. soc. med. Ind.,7,279,,
Cartón nº 8 de 1.00 x 0.70,,,,pliego,2009-07-24,salida,7 cartones membretados sec. General,7,272,,
Cartón nº 8 de 1.00 x 0.70,,,,pliego,2009-09-21,salida,14 pliegos cartón oficina abastecimientos,14,258,,
Cartón nº 8 de 1.00 x 0.70,,,,pliego,2009-11-23,salida,6 pliegos cartón fac. cont. Minas,6,252,,
Cartón nº 8 de 1.00 x 0.70,,,,pliego,2009-11-24,salida,empastado de planillas,17,235,,
Cartón nº 8 de 1.00 x 0.70,,,,pliego,2009-12-23,salida,empaste libros sistemas,2,233,,
Cartón nº 8 de 1.00 x 0.70,,,,pliego,2009-12-29,salida,empaste documentos auditoria,13,220,,
Cartón nº 8 de 1.00 x 0.70,,,,pliego,2010-02-02,salida,empaste documentos vicerrector académico,11,209,,
Cartón nº 8 de 1.00 x 0.70,,,,pliego,2010-03-10,salida,empaste planillas,4,205,,
Cartón nº 8 de 1.00 x 0.70,,,,pliego,2010-03-22,salida,empaste ingenieria civil,4,201,,
Cartón nº 8 de 1.00 x 0.70,,,,pliego,2010-04-07,salida,empaste medicina,2,199,,
Cartón nº 8 de 1.00 x 0.70,,,,pliego,2010-04-13,salida,empaste fac. sociologia,2,197,,
Cartón nº 8 de 1.00 x 0.70,,,,pliego,2010-04-14,salida,empaste medicina,4,193,,
Cartón nº 8 de 1.00 x 0.70,,,,pliego,2010-04-28,salida,empaste PRONACAP (vice rec. Académico),10,183,,
Cartón nº 8 de 1.00 x 0.70,,,,pliego,2010-05-12,salida,empastado auditoria,3,180,,
Cartón nº 8 de 1.00 x 0.70,,,,pliego,2010-05-26,salida,empastado sec. General,7,173,,
Cartón nº 8 de 1.00 x 0.70,,,,pliego,2010-06-03,salida,empastado auditoria,11,162,,
Cartón nº 8 de 1.00 x 0.70,,,,pliego,2010-08-02,salida,empastado sec. General,33,129,,
Cartón nº 8 de 1.00 x 0.70,,,,pliego,2010-09-02,salida,"empastado sociologia, industrias",3,126,,
Cartón nº 8 de 1.00 x 0.70,,,,pliego,2010-09-17,salida,empastado vicerrectorado académico,4,122,,
Cartón nº 8 de 1.00 x 0.70,,,,pliego,2010-09-30,salida,43 empastes registros académicos,43,79,,
Cartón nº 8 de 1.00 x 0.70,,,,pliego,2010-12-06,salida,5 empastados fac. pedagogía,5,74,,
Cartón nº 8 de 1.00 x 0.70,,,,pliego,2010-12-17,salida,2 empastados fac. forestales,2,72,,
Cartón nº 8 de 1.00 x 0.70,,,,pliego,2010-12-22,salida,4 empastados cs. Aplicadas tarma,4,68,,
Cartón nº 8 de 1.00 x 0.70,,,,pliego,2010-12-30,salida,2 empastados oficina de publicaciones,2,66,,
Cartón nº 8 de 1.00 x 0.70,,,,pliego,2011-01-24,salida,4 empastados oficina de publicaciones,4,62,,
Cartón nº 8 de 1.00 x 0.70,,,,pliego,2011-02-16,salida,40 empastados auditoria,40,22,,
Cartón nº 8 de 1.00 x 0.70,,,,pliego,2011-03-11,salida,11 empastes auditoria registros,11,11,,
Cartón nº 8 de 1.00 x 0.70,,,,pliego,2011-09-05,entrada,pecosa PE01136,400,411,83,332
Cartón nº 8 de 1.00 x 0.70,,,,pliego,2011-09-23,salida,empastados oficina tesoreria,12,399,,
Cartón nº 8 de 1.00 x 0.70,,,,pliego,2011-10-10,salida,empastados de actas archivo central,3,396,,
Cartón nº 8 de 1.00 x 0.70,,,,pliego,2011-10-11,salida,empastados de actas archivo central,1,395,,
Cartón nº 8 de 1.00 x 0.70,,,,pliego,2011-11-11,salida,empastados secretaria general,14,381,,
Cartón nº 8 de 1.00 x 0.70,,,,pliego,2011-11-30,salida,6 pliegos empastado de archivo central,6,375,,
Cartón nº 8 de 1.00 x 0.70,,,,pliego,2011-12-13,salida,3 pliegos empastado de libros de secretaria general,3,372,,
Cartón nº 8 de 1.00 x 0.70,,,,pliego,2011-12-29,salida,5 pliegos empastado de libros de secretaria general,5,367,,
Cartulina satinada 150 gramos 50x65 colores,,,,unidad,2010-10-19,entrada,pecosa 121696,500,500,0.24,120
Cartulina satinada 150 gramos 50x65 colores,,,,unidad,2010-12-17,salida,empastado facultad forestales,2,498,,
Cartulina satinada 150 gramos 50x65 colores,,,,unidad,2010-12-22,salida,empastado silabos cs. Aplicadas tarma,20,478,,
Cartulina satinada 150 gramos 50x65 colores,,,,unidad,2010-12-30,salida,empastado oficina de publicaciones,11,467,,
Cartulina satinada 150 gramos 50x65 colores,,,,unidad,2011-01-24,salida,empastado oficina de publicaciones,15,452,,
Cartulina satinada 150 gramos 50x65 colores,,,,unidad,2011-02-16,salida,empastado auditoria,52,400,,
Cartulina satinada 150 gramos 50x65 colores,,,,unidad,2011-02-25,salida,confeccion de kardex control,25,375,,
Cartulina satinada 150 gramos 50x65 colores,,,,unidad,2011-03-11,salida,empastado auditoria registros y materiales,55,320,,
Cartulina satinada 150 gramos 50x65 colores,,,,unidad,2011-03-23,entrada,100 pliegos pecosa,100,420,,
Cartulina satinada 150 gramos 50x65 colores,,,,unidad,2011-04-01,salida,empastados auditoria,35,385,,
Cartulina satinada 150 gramos 50x65 colores,,,,unidad,2011-04-12,salida,empastados facultad pedagogia,7,378,,
Cartulina satinada 150 gramos 50x65 colores,,,,unidad,2011-04-18,salida,empastado libros de sec. General,4,374,,
Cartulina satinada 150 gramos 50x65 colores,,,,unidad,2011-04-20,salida,empastados facultad de zootecnia,3,371,,
Cartulina satinada 150 gramos 50x65 colores,,,,unidad,2011-04-28,salida,planillas,50,321,,
Cartulina satinada 150 gramos 50x65 colores,,,,unidad,2011-05-13,salida,pliegos fac. soc. tarma,6,315,,
Cartulina satinada 150 gramos 50x65 colores,,,,unidad,2011-06-28,salida,pliegos empastado tesoreria,6,309,,
Cartulina satinada 150 gramos 50x65 colores,,,,unidad,2011-07-04,salida,pliegos empastado tesoreria,10,299,,
Cartulina satinada 150 gramos 50x65 colores,,,,unidad,2011-07-11,salida,pliegos empastado tesoreria,9,290,,
Cartulina satinada 150 gramos 50x65 colores,,,,unidad,2011-08-02,salida,pliegos empastado tesoreria,12,278,,
Cartulina satinada 150 gramos 50x65 colores,,,,unidad,2011-08-26,salida,"empastados fac. ind, alimentarias",8,270,,
Cartulina satinada 150 gramos 50x65 colores,,,,unidad,2011-09-01,salida,empastados secretaria general,20,250,,
Cartulina satinada 150 gramos 50x65 colores,,,,unidad,2011-09-05,salida,empastados oficina de publicaciones,3,247,,
Cartulina satinada 150 gramos 50x65 colores,,,,unidad,2011-09-23,salida,empastados tesoreria,8,239,,
Cartulina satinada 150 gramos 50x65 colores,,,,unidad,2011-10-10,salida,empastados de actas archivo central,25,214,,
Cartulina satinada 150 gramos 50x65 colores,,,,unidad,2011-11-11,salida,empastados secretaria general,55,159,,
Cartulina satinada 150 gramos 50x65 colores,,,,unidad,2011-11-30,salida,empastados de archivo,15,144,,
Cartulina satinada 150 gramos 69x89,,,,unidad,2011-09-26,entrada,,500,500,72,360
"Cinta de embalaje 2"" x 25 ydas",shurt,,,unidad,2006-02-28,entrada,PE 00092,60,60,,
"Cinta de embalaje 2"" x 25 ydas",shurt,,,unidad,2006-02-28,salida,,2,58,,
"Cinta de embalaje 2"" x 25 ydas",shurt,,,unidad,2007-07-04,salida,,1,57,,
"Cinta de embalaje 2"" x 25 ydas",shurt,,,unidad,2007-11-19,salida,,2,55,,
"Cinta de embalaje 2"" x 25 ydas",shurt,,,unidad,2007-12-03,salida,,1,54,,
"Cinta de embalaje 2"" x 25 ydas",shurt,,,unidad,2007-02-12,salida,,2,52,,
"Cinta de embalaje 2"" x 25 ydas",shurt,,,unidad,2007-03-19,salida,,1,51,,
"Cinta de embalaje 2"" x 25 ydas",shurt,,,unidad,2008-04-01,salida,,2,49,,
"Cinta de embalaje 2"" x 25 ydas",shurt,,,unidad,2008-04-04,salida,,1,48,,
"Cinta de embalaje 2"" x 25 ydas",shurt,,,unidad,2008-04-08,salida,,1,47,,
"Cinta de embalaje 2"" x 25 ydas",shurt,,,unidad,2008-04-15,salida,,1,46,,
"Cinta de embalaje 2"" x 25 ydas",shurt,,,unidad,2008-04-23,salida,,1,45,,
"Cinta de embalaje 2"" x 25 ydas",shurt,,,unidad,2008-05-19,salida,,1,44,,
"Cinta de embalaje 2"" x 25 ydas",shurt,,,unidad,2008-06-05,salida,,1,43,,
"Cinta de embalaje 2"" x 25 ydas",shurt,,,unidad,2008-06-17,salida,,1,42,,
"Cinta de embalaje 2"" x 25 ydas",shurt,,,unidad,2008-06-30,salida,,1,41,,
"Cinta de embalaje 2"" x 25 ydas",shurt,,,unidad,2008-07-14,salida,,1,40,,
"Cinta de embalaje 2"" x 25 ydas",shurt,,,unidad,2008-07-21,salida,,1,39,,
"Cinta de embalaje 2"" x 25 ydas",shurt,,,unidad,2008-08-04,salida,,1,38,,
"Cinta de embalaje 2"" x 25 ydas",shurt,,,unidad,2008-08-19,salida,,2,36,,
"Cinta de embalaje 2"" x 25 ydas",shurt,,,unidad,2008-08-28,salida,,1,35,,
"Cinta de embalaje 2"" x 25 ydas",shurt,,,unidad,2008-09-02,entrada,pecosa  01366,15,50,,
"Cinta de embalaje 2"" x 25 ydas",shurt,,,unidad,2008-09-12,salida,,1,49,,
"Cinta de embalaje 2"" x 25 ydas",shurt,,,unidad,2008-11-17,salida,,1,48,,
"Cinta de embalaje 2"" x 25 ydas",shurt,,,unidad,2008-11-20,salida,,2,46,,
"Cinta de embalaje 2"" x 25 ydas",shurt,,,unidad,2009-02-05,salida,,1,45,,
"Cinta de embalaje 2"" x 25 ydas",shurt,,,unidad,2009-03-18,salida,,1,44,,
"Cinta de embalaje 2"" x 25 ydas",shurt,,,unidad,2009-04-16,salida,,1,43,,
"Cinta de embalaje 2"" x 25 ydas",shurt,,,unidad,2009-05-06,salida,,1,42,,
"Cinta de embalaje 2"" x 25 ydas",shurt,,,unidad,2009-06-01,salida,,1,41,,
"Cinta de embalaje 2"" x 25 ydas",shurt,,,unidad,2009-07-02,salida,,1,40,,
"Cinta de embalaje 2"" x 25 ydas",shurt,,,unidad,2009-07-07,salida,,1,39,,
"Cinta de embalaje 2"" x 25 ydas",shurt,,,unidad,2009-07-20,salida,,1,38,,
"Cinta de embalaje 2"" x 25 ydas",shurt,,,unidad,2009-08-31,salida,,1,37,,
"Cinta de embalaje 2"" x 25 ydas",shurt,,,unidad,2009-08-31,salida,,1,36,,
"Cinta de embalaje 2"" x 25 ydas",shurt,,,unidad,2009-09-22,salida,,1,35,,
"Cinta de embalaje 2"" x 25 ydas",shurt,,,unidad,2009-11-02,entrada,pecosa,12,47,,
"Cinta de embalaje 2"" x 25 ydas",shurt,,,unidad,2009-12-09,salida,,1,46,,
"Cinta de embalaje 2"" x 25 ydas",shurt,,,unidad,2010-01-21,salida,,1,45,,
"Cinta de embalaje 2"" x 25 ydas",shurt,,,unidad,2010-02-11,salida,,2,43,,
"Cinta de embalaje 2"" x 25 ydas",shurt,,,unidad,2010-03-17,salida,,2,41,,
"Cinta de embalaje 2"" x 25 ydas",shurt,,,unidad,2010-03-30,salida,,1,40,,
"Cinta de embalaje 2"" x 25 ydas",shurt,,,unidad,2010-04-12,salida,,1,39,,
"Cinta de embalaje 2"" x 25 ydas",shurt,,,unidad,2010-04-16,salida,,1,38,,
"Cinta de embalaje 2"" x 25 ydas",shurt,,,unidad,2010-06-02,salida,,1,37,,
"Cinta de embalaje 2"" x 25 ydas",shurt,,,unidad,2010-07-12,salida,,1,36,,
"Cinta de embalaje 2"" x 25 ydas",shurt,,,unidad,2010-07-14,salida,,1,35,,
"Cinta de embalaje 2"" x 25 ydas",shurt,,,unidad,2010-08-10,salida,,1,34,,
"Cinta de embalaje 2"" x 25 ydas",shurt,,,unidad,2010-08-24,entrada,pecosa,7,41,,
"Cinta de embalaje 2"" x 25 ydas",shurt,,,unidad,2010-09-23,salida,,1,40,,
"Cinta de embalaje 2"" x 25 ydas",shurt,,,unidad,2010-10-12,salida,,1,39,,
"Cinta de embalaje 2"" x 25 ydas",shurt,,,unidad,2010-10-22,salida,,1,38,,
"Cinta de embalaje 2"" x 25 ydas",shurt,,,unidad,2010-12-09,salida,,2,36,,
"Cinta de embalaje 2"" x 25 ydas",shurt,,,unidad,2011-01-03,salida,,1,35,,
"Cinta de embalaje 2"" x 25 ydas",shurt,,,unidad,2011-01-03,salida,,1,34,,
"Cinta de embalaje 2"" x 25 ydas",shurt,,,unidad,2011-01-24,salida,,1,33,,
"Cinta de embalaje 2"" x 25 ydas",shurt,,,unidad,2011-01-31,salida,,1,32,,
"Cinta de embalaje 2"" x 25 ydas",shurt,,,unidad,2011-03-23,entrada,pecosa,10,42,,
"Cinta de embalaje 2"" x 25 ydas",shurt,,,unidad,2011-04-05,salida,,1,41,,
"Cinta de embalaje 2"" x 25 ydas",shurt,,,unidad,2011-07-01,salida,,1,40,,
"Cinta de embalaje 2"" x 25 ydas",shurt,,,unidad,2011-10-06,salida,,1,39,,
"Cinta de embalaje 2"" x 25 ydas",shurt,,,unidad,2011-11-21,salida,,1,38,,
"Cinta de embalaje 2"" x 25 ydas",shurt,,,unidad,2011-11-24,salida,,1,37,,
"Cinta de embalaje 2"" x 25 ydas",shurt,,,unidad,2011-12-05,entrada,pecosa 02000,6,43,1.19,7.14
Cola blanca P/Binder duplo DB280,,,,kilos,2011-09-26,entrada,,50,50,18.76,938
Cola elástica (gráfica),fuller,,,balde,2005-12-09,entrada,O/C522,6,6,,
Cola elástica (gráfica),fuller,,,balde,2007-08-29,salida,,1,5,,
Cola gráfica,Industrias Ideal S.A.,,,balde,2007-02-28,entrada,,9,9,,
Cola gráfica,Industrias Ideal S.A.,,,balde,2007-02-28,salida,,1,8,,
Cola gráfica,Industrias Ideal S.A.,,,balde,2007-12-21,salida,,1,7,,
Cola sintética,Multicola,,,balde x 4 kls.,2011-07-27,entrada,,15,15,18,270
Cola sintética,Multicola,,,balde x 4 kls.,2011-09-01,salida,,1,14,,
Cola sintética,Multicola,,,balde x 4 kls.,2011-11-11,salida,,1,13,,
Cola sintética,Multicola,,,balde x 4 kls.,2011-12-29,salida,,1,12,,
Corrector de placas,,,,,2005-03-10,entrada,O/C982,3,3,,
Corrector de placas,,,,,2006-01-03,salida,,1,2,,
Corrector de placas,,,,,2007-12-12,salida,,1,1,,
Corrector de placas,,,,,2008-07-25,entrada,O/C332,2,3,,
Corrector de placas,,,,,2008-12-11,salida,,1,2,,
Cuchillo metálico (repuestos Stanley),,,,10 cajita (c/u x 10 unidades = 100 cuchillitos),2005-09-30,entrada,O/C859,10,10,,
Cuchillo metálico (repuestos Stanley),,,,10 cajita (c/u x 10 unidades = 100 cuchillitos),2005-09-30,salida,,1,9,,
Cuchillo metálico (repuestos Stanley),,,,11 cajita (c/u x 10 unidades = 100 cuchillitos),2006-05-16,salida,,1,8,,
Cuchillo metálico (repuestos Stanley),,,,12 cajita (c/u x 10 unidades = 100 cuchillitos),2006-10-02,salida,,0.5,7.5,,
Cuchillo metálico (repuestos Stanley),,,,13 cajita (c/u x 10 unidades = 100 cuchillitos),2009-05-14,salida,,0.5,7,,
Cuchillos metálicos tipo bisturi (repuestos stanley),,,,cajita x 25,2005-09-30,entrada,O/C859 4 cajas x 100 saldo al 03/11/2005,100,100,,
Cuchillos metálicos tipo bisturi (repuestos stanley),,,,cajita x 25,2006-09-15,salida,,25,75,,
Cuchillos metálicos tipo bisturi (repuestos stanley),,,,cajita x 25,2007-08-10,salida,,25,50,,
Cuchillos metálicos tipo bisturi (repuestos stanley),,,,cajita x 25,2008-09-10,salida,,25,25,,
Cuchillos metálicos tipo bisturi (repuestos stanley),,,,cajita x 25,2010-06-01,salida,,1,24,,
Esponjas o gayetas,,44515206,,unidad,2004-11-19,entrada,O/C 984-PEO1180,10,10,,
Esponjas o gayetas,,44515206,,unidad,2005-03-10,salida,,3,7,,
Esponjas o gayetas,,44515206,,unidad,2005-05-17,entrada,O/C 197,24,31,,
Esponjas o gayetas,,44515206,,unidad,2005-11-03,salida,,2,29,,
Esponjas o gayetas,,44515206,,unidad,2006-05-16,salida,,1,28,,
Esponjas o gayetas,,44515206,,unidad,2006-05-29,salida,,1,27,,
Esponjas o gayetas,,44515206,,unidad,2006-09-07,salida,,1,26,,
Esponjas o gayetas,,44515206,,unidad,2006-09-29,salida,,1,25,,
Esponjas o gayetas,,44515206,,unidad,2007-01-05,salida,,1,24,,
Esponjas o gayetas,,44515206,,unidad,2007-01-28,salida,,3,21,,
Esponjas o gayetas,,44515206,,unidad,2007-12-21,salida,,4,17,,
Esponjas o gayetas,,44515206,,unidad,2008-04-21,salida,,1,16,,
Esponjas o gayetas,,44515206,,unidad,2008-08-15,salida,,1,15,,
Esponjas o gayetas,,44515206,,unidad,2008-11-21,salida,,1,14,,
Esponjas o gayetas,,44515206,,unidad,2009-02-05,salida,,1,13,,
Esponjas o gayetas,,44515206,,unidad,2009-06-01,salida,,1,12,,
Esponjas o gayetas,,44515206,,unidad,2009-08-31,salida,,1,11,,
Esponjas o gayetas,,44515206,,unidad,2009-12-17,salida,,1,10,,
Esponjas o gayetas,,44515206,,unidad,2009-12-18,salida,,2,8,,
Esponjas o gayetas,,44515206,,unidad,2010-04-19,salida,,1,7,,
Esponjas o gayetas,,44515206,,unidad,2010-07-14,salida,,1,6,,
Esponjas o gayetas,,44515206,,unidad,2010-08-23,salida,,1,5,,
Esponjas o gayetas,,44515206,,unidad,2010-10-01,salida,,1,4,,
Esponjas o gayetas,,44515206,,unidad,2010-10-28,entrada,PE01757,10,14,,
Esponjas o gayetas,,44515206,,unidad,2011-05-13,salida,,2,12,,
Glicerina Q. P.,Figher U.S.A.,,,galones,2005-04-14,entrada,PE 00386 (1 galonera),6,6,,
Goma protectora,Gummi,44515212,por 4 litros,galón,2004-12-30,entrada,O/C 1024 - PEO1461,1,1,,
Goma protectora,Gummi,44515212,por 4 litros,galón,2004-11-09,entrada,O/C 684 - PE01180,3,4,,
Goma protectora,Gummi,44515212,por 4 litros,galón,2005-11-03,salida,,0.5,3.5,,
Goma protectora,Gummi,44515212,por 4 litros,galón,2005-12-15,salida,,0.5,3,,
Goma protectora,Gummi,44515212,por 4 litros,galón,2006-05-16,salida,,0.5,2.5,,
Goma protectora,Gummi,44515212,por 4 litros,galón,2006-10-31,salida,,0.25,2.25,,
Goma protectora,Gummi,44515212,por 4 litros,galón,2007-01-03,salida,,0.25,2,,
Goma protectora,Gummi,44515212,por 4 litros,galón,2007-05-29,salida,,0.5,1.5,,
Goma protectora,Gummi,44515212,por 4 litros,galón,2007-07-26,entrada,O/C 00527,1,2.5,,
Goma protectora,Gummi,44515212,por 4 litros,galón,2008-03-05,salida,,0.25,2.25,,
Goma protectora,Gummi,44515212,por 4 litros,galón,2008-10-15,salida,,0.15,2.1,,
Goma protectora,Gummi,44515212,por 4 litros,galón,2010-10-05,salida,,0.1,2,,
Goma protectora,Gummi,44515212,por 4 litros,galón,2010-10-28,entrada,PE 01757,2,4,,
Goma protectora,Gummi,44515212,por 4 litros,galón,2011-09-01,salida,,0.5,3.5,,
Grapas n° 23/8,Mirage,44360450,,,2004-11-05,entrada,PE01164,10,10,,
Grapas n° 23/8,Mirage,44360450,,,2005-04-14,entrada,,10,20,,
Grapas n° 23/8,Mirage,44360450,,,2005-11-03,salida,,1,19,,
Grapas n° 23/8,Mirage,44360450,,,2006-10-04,salida,,2,17,,
Grapas n° 23/10,Mirage,44360445,,cajitas,2004-11-05,entrada,PE01164,10,10,,
Grapas n° 23/10,Mirage,44360445,,cajitas,2005-04-14,entrada,,10,20,,
Grapas n° 23/10,Mirage,44360445,,cajitas,2005-11-03,salida,,1,19,,
Grapas n° 23/10,Mirage,44360445,,cajitas,2005-11-08,entrada,encontrado al arreglar la oficina de pub. e impresiones,1,20,,
Grapas n° 23/10,Mirage,44360445,,cajitas,2006-12-13,salida,,1,19,,
Grapas 23/12,Mirage,44360440,,cajitas,2004-11-05,entrada,PEO 1163,10,10,,
Grapas 23/12,Mirage,44360440,,cajitas,2005-04-14,entrada,,10,20,,
Grapas 23/12,Mirage,44360440,,cajitas,2005-11-08,entrada,encontrado al arreglar la oficina de pub. e impresiones,5,25,,
Grapas 23/12,Mirage,44360440,,cajitas,2007-03-05,salida,,2,23,,
Grapas 23/15,Mirage,44360435,,cajitas,2004-01-05,entrada,PEO1163,10,10,,
Grapas 23/15,Mirage,44360435,,cajitas,2005-04-14,entrada,,10,20,,
Grapas 23/15,Mirage,44360435,,cajitas,2005-11-03,salida,,1,19,,
Grapas 23/15,Mirage,44360435,,cajitas,2005-11-08,entrada,encontrado al arreglar la oficina de pub. e impresiones,3,22,,
Grapas 23/15,Mirage,44360435,,cajitas,2006-01-05,salida,,1,21,,
Grapas 23/15,Mirage,44360435,,cajitas,2006-11-23,salida,,1,20,,
Grapas 23/15,Mirage,44360435,,cajitas,2011-07-21,salida,,1,19,,
Grapas n° 23/6,Skrebba,,,cajitas,2007-09-12,entrada,O/C 679 - PE01253,12,12,,
Grapas n° 23/6,Skrebba,,,cajitas,2010-10-09,salida,,1,11,,
Grapas 23/8,Skrebba,,,cajitas,2007-09-12,entrada,O/C 679 - PE01253,12,12,,
Grapas 23/8,Skrebba,,,cajitas,2008-02-08,salida,memoria 2006,1,11,,
Grapas 23/8,Skrebba,,,cajitas,2009-01-15,salida,815 revistas informativas de investigación,2,9,,
Grapa n° 23/12,Skrebba,,,cajitas,2007-09-12,entrada,O/C 679 - PE01253,12,12,,
Grapa n° 23/12,Skrebba,,,cajitas,2008-11-14,salida,1 caja memoria,1,11,,
Grapa 23/15,Skrebba,,,cajitas,2007-02-28,entrada,O/C 0018,20,20,,
Grapa 23/15,Skrebba,,,cajitas,2007-03-07,salida,,1,19,,
Grapa 23/15,Skrebba,,,cajitas,2007-05-05,salida,,1,18,,
Grapa 23/15,Skrebba,,,cajitas,2011-07-22,salida,,1,17,,
Grapas Staples DBM,,,,cajita x 5000 grapas,2011-08-19,entrada,PE 01075,120,120,4,480
Kit de Drum Unit. GPR-20 black,,,black,unidad,2010-08-25,entrada,,4,4,880,3520
Kit de Drum Unit. GPR-20 black,,,black,unidad,2010-09-14,salida,,1,3,,
Kit de Drum Unit. GPR-20 black,,,black,unidad,2011-09-01,salida,,1,2,,
Kit de Drum Unit. GPR-20 black,,,black,unidad,2011-12-07,salida,,1,1,,
Kit de Drum Unit. GPR-20 cyan,,,cyan,unidad,2010-08-26,entrada,,2,2,1245,2490
Kit de Drum Unit. GPR-20 cyan,,,cyan,unidad,2011-09-01,salida,,1,1,,
Kit de Drum Unit. GPR-20 cyan,,,cyan,unidad,2011-12-07,salida,,1,0,,
Kit de Drum Unit. GPR-20 magenta,,,magenta,unidad,2010-08-27,entrada,,2,2,1245,2490
Kit de Drum Unit. GPR-20 magenta,,,magenta,unidad,2011-09-01,salida,,1,1,,
Kit de Drum Unit. GPR-20 magenta,,,magenta,unidad,2011-12-07,salida,,1,0,,
Kit de Drum Unit. GPR-20 yellow,,,yellow,unidad,2010-08-28,entrada,,4,4,1245,4980
Kit de Drum Unit. GPR-20 yellow,,,yellow,unidad,2011-09-01,salida,,1,3,,
Kit de Drum Unit. GPR-20 yellow,,,yellow,unidad,2011-12-07,salida,,1,2,,
Limpiador de rodillos,Lingraf,,,galones x 4 litros,2008-07-25,entrada,O/C 332,20,20,,
Limpiador de rodillos,Lingraf,,,galones x 4 litros,2008-11-25,salida,,2,18,,
Limpiador de rodillos,Lingraf,,,galones x 4 litros,2008-11-15,salida,,1,17,,
Limpiador de rodillos,Lingraf,,,galones x 4 litros,2009-02-09,salida,,4,13,,
Limpiador de rodillos,Lingraf,,,galones x 4 litros,2009-03-18,salida,,2,11,,
Limpiador de rodillos,Lingraf,,,galones x 4 litros,2009-04-08,salida,,1,10,,
Limpiador de rodillos,Lingraf,,,galones x 4 litros,2009-06-12,salida,,2,8,,
Limpiador de rodillos,Lingraf,,,galones x 4 litros,2009-07-03,salida,,2,6,,
Limpiador de rodillos,Lingraf,,,galones x 4 litros,2009-08-27,salida,,1,5,,
Limpiador de rodillos,Lingraf,,,galones x 4 litros,2009-09-11,salida,,2,3,,
Limpiador de rodillos,Lingraf,,,galones x 4 litros,2009-12-04,salida,,1,2,,
Limpiador de rodillos,Lingraf,,,galones x 4 litros,2009-12-23,entrada,O/C 1136 PE 2036,20,22,,
Limpiador de rodillos,Lingraf,,,galones x 4 litros,2010-01-05,salida,,2,20,,
Limpiador de rodillos,Lingraf,,,galones x 4 litros,2010-05-12,salida,,4,16,,
Limpiador de rodillos,Lingraf,,,galones x 4 litros,2010-08-19,salida,,4,12,,
Limpiador de rodillos,Lingraf,,,galones x 4 litros,2010-11-05,salida,,4,8,,
Limpiador de rodillos,Lingraf,,,galones x 4 litros,2010-10-28,entrada,PE 01757 - 15 galones,60,68,31,465
Limpiador de rodillos,Lingraf,,,galones x 4 litros,2010-11-12,salida,mantenimiento gasto Heidelberg,8,60,,
Limpiador de rodillos,Lingraf,,,galones x 4 litros,2011-01-27,salida,,4,56,,
Limpiador de rodillos,Lingraf,,,galones x 4 litros,2011-04-10,salida,1 galon,4,52,,
Limpiador de rodillos,Lingraf,,,galones x 4 litros,2011-07-12,salida,2 galones,8,44,,
Limpiador de rodillos,Lingraf,,,galones x 4 litros,2011-08-18,salida,1 galon,4,40,,
Limpiador de rodillos,Lingraf,,,galones x 4 litros,2011-10-18,salida,1 galon,4,36,,
Limpiador de rodillos Prego,Prego,,,galones x 4 litros,2011-07-27,entrada,,8,8,27,216
"Renar, limpiador de tinta seca",Antaris,,,frascos x 1 litro,2011-07-27,entrada,,5,5,25,125
"Renar, limpiador de tinta seca",Antaris,,,frascos x 1 litro,2011-08-08,salida,,1,4,,
Mantillas comprensibles 445x520x1.95,,,,unidad,2005-05-17,entrada,,5,5,,
Mantillas comprensibles 445x520x1.95,,,,unidad,2005-12-21,salida,,1,4,,
Mantillas comprensibles 445x520x1.95,,,,unidad,2006-10-02,salida,,1,3,,
Mantillas comprensibles 445x520x1.95,,,,unidad,2007-01-25,salida,,1,2,,
Mantillas comprensibles 445x520x1.95,,,,unidad,2007-01-31,salida,,1,1,,
Mantillas comprensibles 445x520x1.95,,,,unidad,2007-04-23,salida,,1,0,,
Mantillas comprensibles 445x520x1.95,,,,unidad,2008-05-29,entrada,O/C 00331,5,5,,
Mantillas comprensibles 445x520x1.95,,,,unidad,2008-11-27,salida,,1,4,,
Mantillas comprensibles 445x520x1.95,,,,unidad,2008-12-15,salida,,1,3,,
Mantillas comprensibles 445x520x1.95,,,,unidad,2009-07-31,salida,,1,2,,
Mantillas comprensibles 445x520x1.95,,,,unidad,2009-12-17,salida,,1,1,,
Mantillas comprensibles 445x520x1.95,,,,unidad,2010-07-02,salida,,1,0,,
Mantillas comprensibles 445x520x1.95,,,,unidad,2010-10-28,entrada,PE 01757,5,5,,
Mantillas comprensibles 445x520x1.95,,,,unidad,2010-12-20,salida,,1,4,,
Opalina de 70x100 x 180 gramos,Fedrigoni,,,resma x 100 hojas,2011-07-27,entrada,,300,300,100,300
Opalina de 70x100 x 180 gramos,Fedrigoni,,,resma x 100 hojas,2011-12-13,salida,tarjetas de invitacion 75 pliegos aniversario,75,225,,
Papel bond 75 gramos de 69x89x500,,,,resma,2011-09-26,entrada,,20,20,116.7,2334
Papel bond 75 gramos de 69x89x500,,,,resma,2011-10-12,salida,cambio por TA4,1,19,,
Papel bond 75 gramos de 69x89x500,,,,resma,2011-10-24,salida,,2.835,16.165,,
Papel bond 75 gramos de 69x89x500,,,,resma,2011-12-13,salida,,0.065,16.1,,
Papel bond 80 gramos tamaño A4,Atlas,,,millar,2007-07-02,entrada,10 millares A4,10,10,,
Papel bond 80 gramos tamaño A4,Atlas,,,millar,2007-07-10,salida,cambio con T/O,1.5,8.5,,
Papel bond 80 gramos tamaño A4,Atlas,,,millar,2007-07-16,salida,of. Publicaciones,0.5,8,,
Papel bond 80 gramos tamaño A4,Atlas,,,millar,2007-07-18,salida,almacen cambio por oficio (-3),3,5,,
Papel bond 80 gramos tamaño A4,Atlas,,,millar,2007-08-16,salida,almacen cambio por oficio (-5),5,0,,
Papel bond 80 gramos tamaño A4,Atlas,,,millar,2007-09-04,entrada,almacen cambio por oficio,5,5,,
Papel bond 80 gramos tamaño A4,Atlas,,,millar,2007-09-04,salida,para uso de la oficina de publicaciones,0.5,4.5,,
Papel bond 80 gramos tamaño A4,Atlas,,,millar,2007-09-25,salida,1/2 millar para uso de la oficina de publicaciones,0.5,4,,
Papel bond 80 gramos tamaño A4,Atlas,,,millar,2007-10-15,salida,1/2 millar para uso de la oficina de publicaciones,0.5,3.5,,
Papel bond 80 gramos tamaño A4,Atlas,,,millar,2007-11-23,entrada,se cambia a secretaria general mas 5,5,8.5,,
Papel bond 80 gramos tamaño A4,Atlas,,,millar,2008-01-09,salida,menos 1 millar se cambio almacen por T/O,1,7.5,,
Papel bond 80 gramos tamaño A4,Atlas,,,millar,2008-01-10,salida,1/2 millar para uso de la oficina de publicaciones,0.5,7,,
Papel bond 80 gramos tamaño A4,Atlas,,,millar,2008-01-25,salida,menos 2 millares cambio por T/O,2,5,,
Papel bond 80 gramos tamaño A4,Atlas,,,millar,2008-01-28,salida,1/2 millar para uso de la oficina de publicaciones,0.5,4.5,,
Papel bond 80 gramos tamaño A4,Atlas,,,millar,2008-02-12,salida,menos 1 millar se cambio almacen por T/O,1,3.5,,
Papel bond 80 gramos tamaño A4,Atlas,,,millar,2008-02-19,salida,1 millar vice rectorado académico,1,2.5,,
Papel bond 80 gramos tamaño A4,Atlas,,,millar,2008-02-19,salida,1/2 millar para uso de la oficina de publicaciones,0.5,2,,
Papel bond 80 gramos tamaño A4,Atlas,,,millar,2008-04-01,salida,1 millar cambio por T/O,1,1,,
Papel bond 80 gramos tamaño A4,Atlas,,,millar,2008-04-09,salida,1/2 millar para uso de la oficina de publicaciones,0.5,0.5,,
Papel bond 80 gramos tamaño A4,Atlas,,,millar,2008-05-15,salida,1/2 millar para uso de la oficina de publicaciones,0.5,0,,
Papel bond 80 gramos tamaño A4,Atlas,,,millar,2008-06-16,entrada,6 millares cambio por T/O,6,6,,
Papel bond 80 gramos tamaño A4,Atlas,,,millar,2008-07-14,salida,1 millar cambio por T/O,1,5,,
Papel bond 80 gramos tamaño A4,Atlas,,,millar,2008-07-24,salida,1/2 millar cambio por T/O,0.5,4.5,,
Papel bond 80 gramos tamaño A4,Atlas,,,millar,2008-08-07,salida,2 millares cambio por T/O,2,2.5,,
Papel bond 80 gramos tamaño A4,Atlas,,,millar,2008-08-11,salida,1 millar cambio por T/O,1,1.5,,
Papel bond 80 gramos tamaño A4,Atlas,,,millar,2008-08-12,entrada,5 millares cambio por T/O,5,6.5,,
Papel bond 80 gramos tamaño A4,Atlas,,,millar,2008-08-27,salida,1/2 millar cambio por T/O,0.5,6,,
Papel bond 80 gramos tamaño A4,Atlas,,,millar,2008-08-28,salida,1/2 millar para uso de la oficina de publicaciones,0.5,5.5,,
Papel bond 80 gramos tamaño A4,Atlas,,,millar,2008-08-28,salida,5 millares cambio por T/O,5,0.5,,
Papel bond 80 gramos tamaño A4,Atlas,,,millar,2008-09-22,salida,1/2 millar para uso de la oficina de publicaciones,0.5,0,,
Papel bond 80 gramos tamaño A4,Atlas,,,millar,2009-02-27,entrada,devolucion 2 millares T/O secretaria general,2,2,,
Papel bond 80 gramos tamaño A4,Atlas,,,millar,2009-03-10,salida,cambio por 1 millar T/O,1,1,,
Papel bond 80 gramos tamaño A4,Atlas,,,millar,2009-03-11,salida,1/2 millar cambio por T/O,0.5,0.5,,
Papel bond 80 gramos tamaño A4,Atlas,,,millar,2009-03-11,entrada,80 millares pecosa PE 00148,80,80.5,,
Papel bond 80 gramos tamaño A4,Atlas,,,millar,2009-03-12,salida,6 millares membretado rectorado vicerrectorado,6,74.5,,
Papel bond 80 gramos tamaño A4,Atlas,,,millar,2009-03-23,salida,1/2 millar para uso de la oficina de publicaciones,0.5,74,,
Papel bond 80 gramos tamaño A4,Atlas,,,millar,2009-04-22,salida,1 millar cambio por T/O,1,73,,
Papel bond 80 gramos tamaño A4,Atlas,,,millar,2009-04-27,salida,1/2 millar para uso de la oficina de publicaciones,0.5,72.5,,
Papel bond 80 gramos tamaño A4,Atlas,,,millar,2009-05-08,salida,1/2 millar para uso de la oficina de publicaciones,0.5,72,,
Papel bond 80 gramos tamaño A4,Atlas,,,millar,2009-05-12,salida,1 millar cambio por T/O,1,71,,
Papel bond 80 gramos tamaño A4,Atlas,,,millar,2009-05-13,salida,3 millares cambio por T/O,3,68,,
Papel bond 80 gramos tamaño A4,Atlas,,,millar,2009-05-21,salida,1 1/2 millar cambio por T/O,1.5,66.5,,
Papel bond 80 gramos tamaño A4,Atlas,,,millar,2009-06-01,salida,3 millares cambio por T/O,3,63.5,,
Papel bond 80 gramos tamaño A4,Atlas,,,millar,2009-06-25,salida,1/2 millar cambio por T/O,0.5,63,,
Papel bond 80 gramos tamaño A4,Atlas,,,millar,2009-06-26,salida,1/2 millar cambio por T/O,0.5,62.5,,
Papel bond 80 gramos tamaño A4,Atlas,,,millar,2009-07-02,salida,4 millares membretes fac. sociologia y sistemas,4,58.5,,
Papel bond 80 gramos tamaño A4,Atlas,,,millar,2009-07-07,salida,1/2 millar trabajo de oficina,0.5,58,,
Papel bond 80 gramos tamaño A4,Atlas,,,millar,2009-07-08,salida,1/2 millar cambio por T/O,0.5,57.5,,
Papel bond 80 gramos tamaño A4,Atlas,,,millar,2009-07-09,salida,1/2 millar cambio por T/O,0.5,57,,
Papel bond 80 gramos tamaño A4,Atlas,,,millar,2009-08-20,salida,1/2 millar cambio por T/O,0.5,56.5,,
Papel bond 80 gramos tamaño A4,Atlas,,,millar,2009-08-27,salida,4 millares membretes fac. satipo y abastecimientos,4,52.5,,
Papel bond 80 gramos tamaño A4,Atlas,,,millar,2009-09-04,salida,1/2 millar para uso de la oficina de publicaciones,0.5,52,,
Papel bond 80 gramos tamaño A4,Atlas,,,millar,2009-09-10,salida,1/2 millar cambio por T/O,0.5,51.5,,
Papel bond 80 gramos tamaño A4,Atlas,,,millar,2009-09-14,salida,2 millares membretes facultad ing. Quimica,2,49.5,,
Papel bond 80 gramos tamaño A4,Atlas,,,millar,2009-09-21,salida,1/2 millar cambio por T/O,0.5,49,,
Papel bond 80 gramos tamaño A4,Atlas,,,millar,2009-09-22,salida,1 millar cambio por T/O,1,48,,
Papel bond 80 gramos tamaño A4,Atlas,,,millar,2009-09-22,salida,3 millares cambio por T/O,3,45,,
Papel bond 80 gramos tamaño A4,Atlas,,,millar,2009-09-23,salida,"6 millares membretado medicina, pedagogia, electrica",6,39,,
Papel bond 80 gramos tamaño A4,Atlas,,,millar,2009-10-01,salida,"14 millares membretado fac.adm.Agr.Arq.Cscom.ContMf,minas,tarma,civil",14,25,,
Papel bond 80 gramos tamaño A4,Atlas,,,millar,2009-10-02,salida,1/2 millar para uso de la oficina de publicaciones,0.5,24.5,,
Papel bond 80 gramos tamaño A4,Atlas,,,millar,2009-10-05,salida,1/2 millar cambio por T/O,0.5,24,,
Papel bond 80 gramos tamaño A4,Atlas,,,millar,2009-10-12,salida,1/2 millar cambio por T/O,0.5,23.5,,
Papel bond 80 gramos tamaño A4,Atlas,,,millar,2009-10-16,salida,1/2 millar cambio por T/O,0.5,23,,
Papel bond 80 gramos tamaño A4,Atlas,,,millar,2009-10-20,salida,1/2 millar cambio por T/O,0.5,22.5,,
Papel bond 80 gramos tamaño A4,Atlas,,,millar,2009-11-02,salida,2 millares proyeccion soc. planificacion,2,20.5,,
Papel bond 80 gramos tamaño A4,Atlas,,,millar,2009-11-09,salida,1/2 millar para uso de la oficina de publicaciones,0.5,20,,
Papel bond 80 gramos tamaño A4,Atlas,,,millar,2009-11-16,salida,1/2 millar cambio por T/O,0.5,19.5,,
Papel bond 80 gramos tamaño A4,Atlas,,,millar,2009-11-24,salida,2 millares cambio por T/O,2,17.5,,
Papel bond 80 gramos tamaño A4,Atlas,,,millar,2009-11-24,salida,5 millares cambio por T/O,5,12.5,,
Papel bond 80 gramos tamaño A4,Atlas,,,millar,2009-12-14,salida,1 1/2 millar agenda 2010,1.5,11,,
Papel bond 80 gramos tamaño A4,Atlas,,,millar,2009-12-14,salida,1/2 millar para uso de la oficina de publicaciones,0.5,10.5,,
Papel bond 80 gramos tamaño A4,Atlas,,,millar,2010-01-13,entrada,1 1/2 millar cambio por T/O,1.5,12,,
Papel bond 80 gramos tamaño A4,Atlas,,,millar,2010-01-15,salida,1/2 millar para uso de la oficina de publicaciones,0.5,11.5,,
Papel bond 80 gramos tamaño A4,Atlas,,,millar,2010-02-24,salida,1/2 millar cambio por T/O,0.5,11,,
Papel bond 80 gramos tamaño A4,Atlas,,,millar,2010-02-19,salida,1 millar cambio por papel bond de color,1,10,,
Papel bond 80 gramos tamaño A4,Atlas,,,millar,2010-03-10,salida,2 millares cambio por T/O,2,8,,
Papel bond 80 gramos tamaño A4,Atlas,,,millar,2010-03-11,salida,1/2 millar cambio por T/O,0.5,7.5,,
Papel bond 80 gramos tamaño A4,Atlas,,,millar,2010-03-12,salida,1/2 millar para uso de la oficina de publicaciones,0.5,7,,
Papel bond 80 gramos tamaño A4,Atlas,,,millar,2010-03-15,salida,1/2 millar cambio por T/O,0.5,6.5,,
Papel bond 80 gramos tamaño A4,Atlas,,,millar,2010-03-16,salida,1 millar cambio por T/O,1,5.5,,
Papel bond 80 gramos tamaño A4,Atlas,,,millar,2010-03-25,salida,1/2 millar pruebas compaginadora y encoladora,0.5,5,,
Papel bond 80 gramos tamaño A4,Atlas,,,millar,2010-03-25,salida,2 millares cambio por T/O,2,3,,
Papel bond 80 gramos tamaño A4,Atlas,,,millar,2010-04-05,salida,2 millares cambio por T/O,2,1,,
Papel bond 80 gramos tamaño A4,Atlas,,,millar,2010-04-13,salida,1/2 millar oficina bienestar,0.5,0.5,,
Papel bond 80 gramos tamaño A4,Atlas,,,millar,2010-04-13,salida,1/2 millar documentacion oficina,0.5,0,,
Papel bond 80 gramos tamaño A4,Atlas,,,millar,2011-02-25,entrada,13.5 millares de la conversion del papel tamaño resma 69x89x500,13.5,13.5,,
Papel bond 80 gramos tamaño A4,Atlas,,,millar,2011-02-25,salida,1 millar se cambio por T/O,1,12.5,,
Papel bond 80 gramos tamaño A4,Atlas,,,millar,2011-02-25,salida,1/2 millar para uso de la oficina de publicaciones,0.5,12,,
Papel bond 80 gramos tamaño A4,Atlas,,,millar,2011-03-11,salida,1/2 millar cambio por T/O,0.5,11.5,,
Papel bond 80 gramos tamaño A4,Atlas,,,millar,2011-03-18,salida,1/2 millar para uso de la oficina de publicaciones,0.5,11,,
Papel bond 80 gramos tamaño A4,Atlas,,,millar,2011-03-22,salida,1 millar para uso de la oficina de publicaciones,0.5,10.5,,
Papel bond 80 gramos tamaño A4,Atlas,,,millar,2011-04-13,salida,1 millar cambio por T/O,1,9.5,,
Papel bond 80 gramos tamaño A4,Atlas,,,millar,2011-05-09,salida,2 millares cambio por T/O,2,7.5,,
Papel bond 80 gramos tamaño A4,Atlas,,,millar,2011-05-11,salida,2 millares cambio por T/O,2,5.5,,
Papel bond 80 gramos tamaño A4,Atlas,,,millar,2011-07-04,salida,1/2 millar cambio por T/O,0.5,5,,
Papel bond 80 gramos tamaño A4,Atlas,,,millar,2011-08-18,salida,3 millares cambio por T/O,3,2,,
Papel bond 80 gramos tamaño A4,Atlas,,,millar,2011-08-22,salida,1/2 millar cambio para uso de la oficina,0.5,1.5,,
Papel bond 80 gramos tamaño A4,Atlas,,,millar,2011-09-02,salida,1/2 millar cambio por T/O,0.5,1,,
Papel bond 80 gramos tamaño A4,Atlas,,,millar,2011-09-08,salida,1/2 millar para uso de la oficina de publicaciones,0.5,0.5,,
Papel bond 80 gramos tamaño A4,Atlas,,,millar,2011-09-21,entrada,1 millar cambio por T/O,1,1.5,,
Papel bond 80 gramos tamaño A4,Atlas,,,millar,2011-09-28,salida,1/2 millar cambio por T/O,0.5,1,,
Papel bond 80 gramos tamaño A4,Atlas,,,millar,2011-09-30,salida,1/2 millar cambio por T/O,0.5,0.5,,
Papel bond 80 gramos tamaño A4,Atlas,,,millar,2011-10-12,entrada,4 millares cambio por T/resma,4,4.5,,
Papel bond 80 gramos tamaño A4,Atlas,,,millar,2011-10-13,salida,uso de la oficina 1/2 millar,0.5,4,,
Papel bond 80 gramos tamaño A4,Atlas,,,millar,2011-10-14,salida,1 1/2 millar cambio por T/O,1.5,2.5,,
Papel bond 80 gramos tamaño A4,Atlas,,,millar,2011-12-28,salida,1/2 millar oficina  ,0.5,2,,
Papel bond 80 gramos tamaño oficio,Atlas,,,millar,2007-07-02,entrada,5 millares T/of,5,5,,
Papel bond 80 gramos tamaño oficio,Atlas,,,millar,2007-07-10,entrada,cambio con A4,1.5,6.5,,
Papel bond 80 gramos tamaño oficio,Atlas,,,millar,2007-07-18,entrada,almacen cambio por A4,3,9.5,,
Papel bond 80 gramos tamaño oficio,Atlas,,,millar,2007-08-16,entrada,almacen cambio por A4,5,14.5,,
Papel bond 80 gramos tamaño oficio,Atlas,,,millar,2007-09-04,salida,se cambio por papel bond A4,5,9.5,,
Papel bond 80 gramos tamaño oficio,Atlas,,,millar,2007-11-23,salida,se cambio a secretaria general,5,4.5,,
Papel bond 80 gramos tamaño oficio,Atlas,,,millar,2008-01-09,entrada,se cambio por A4,1,5.5,,
Papel bond 80 gramos tamaño oficio,Atlas,,,millar,2008-01-25,entrada,se cambio por A4,2,7.5,,
Papel bond 80 gramos tamaño oficio,Atlas,,,millar,2008-02-12,entrada,se cambio por A4,1,8.5,,
Papel bond 80 gramos tamaño oficio,Atlas,,,millar,2008-02-22,salida,1/2 millar para uso de oficina de publicaciones,0.5,8,,
Papel bond 80 gramos tamaño oficio,Atlas,,,millar,2008-04-01,entrada,se cambio por A4,1,9,,
Papel bond 80 gramos tamaño oficio,Atlas,,,millar,2008-06-16,salida,se cambio por A4,6,3,,
Papel bond 80 gramos tamaño oficio,Atlas,,,millar,2008-07-14,entrada,se cambio por A4,1,4,,
Papel bond 80 gramos tamaño oficio,Atlas,,,millar,2008-07-24,entrada,se cambio por A4,0.5,4.5,,
Papel bond 80 gramos tamaño oficio,Atlas,,,millar,2008-08-07,entrada,se cambio por A4,2,6.5,,
Papel bond 80 gramos tamaño oficio,Atlas,,,millar,2008-08-11,entrada,se cambio por A4,1,7.5,,
Papel bond 80 gramos tamaño oficio,Atlas,,,millar,2008-08-12,salida,se cambio por A4,5,2.5,,
Papel bond 80 gramos tamaño oficio,Atlas,,,millar,2008-08-27,entrada,se cambio por A4,0.5,3,,
Papel bond 80 gramos tamaño oficio,Atlas,,,millar,2008-08-28,entrada,se cambio por A4,5,8,,
Papel bond 80 gramos tamaño oficio,Atlas,,,millar,2009-02-09,salida,2 millares para membrete secretaria general,2,6,,
Papel bond 80 gramos tamaño oficio,Atlas,,,millar,2009-03-10,entrada,se cambio por A4,1,7,,
Papel bond 80 gramos tamaño oficio,Atlas,,,millar,2009-03-11,entrada,se cambio por A4,0.5,7.5,,
Papel bond 80 gramos tamaño oficio,Atlas,,,millar,2009-04-22,entrada,se cambio por A4,1,8.5,,
Papel bond 80 gramos tamaño oficio,Atlas,,,millar,2009-05-12,entrada,se cambio por A4,1,9.5,,
Papel bond 80 gramos tamaño oficio,Atlas,,,millar,2009-05-18,entrada,se cambio por A4,3,12.5,,
Papel bond 80 gramos tamaño oficio,Atlas,,,millar,2009-05-21,entrada,se cambio por A4,1.5,14,,
Papel bond 80 gramos tamaño oficio,Atlas,,,millar,2009-06-04,entrada,se cambio por A4,3,17,,
Papel bond 80 gramos tamaño oficio,Atlas,,,millar,2009-06-25,entrada,se cambio por A4,0.5,17.5,,
Papel bond 80 gramos tamaño oficio,Atlas,,,millar,2009-06-26,entrada,se cambio por A4,0.5,18,,
Papel bond 80 gramos tamaño oficio,Atlas,,,millar,2009-07-08,entrada,se cambio por A4,0.5,18.5,,
Papel bond 80 gramos tamaño oficio,Atlas,,,millar,2009-07-09,entrada,se cambio por A4,0.5,19,,
Papel bond 80 gramos tamaño oficio,Atlas,,,millar,2009-08-20,entrada,se cambio por A4,0.5,19.5,,
Papel bond 80 gramos tamaño oficio,Atlas,,,millar,2009-09-03,salida,7 millares a cambio de 3 millares de papel doble oficio 90 gramos,7,12.5,,
Papel bond 80 gramos tamaño oficio,Atlas,,,millar,2009-09-10,entrada,se cambio por A4,0.5,13,,
Papel bond 80 gramos tamaño oficio,Atlas,,,millar,2009-09-21,entrada,se cambio por A4,0.5,13.5,,
Papel bond 80 gramos tamaño oficio,Atlas,,,millar,2009-09-22,entrada,se cambio por A4,1,14.5,,
Papel bond 80 gramos tamaño oficio,Atlas,,,millar,2009-09-22,entrada,se cambio por A4,3,17.5,,
Papel bond 80 gramos tamaño oficio,Atlas,,,millar,2009-10-05,entrada,se cambio por A4,0.5,18,,
Papel bond 80 gramos tamaño oficio,Atlas,,,millar,2009-10-12,entrada,se cambio por A4,0.5,18.5,,
Papel bond 80 gramos tamaño oficio,Atlas,,,millar,2009-10-16,entrada,se cambio por A4,0.5,19,,
Papel bond 80 gramos tamaño oficio,Atlas,,,millar,2009-10-20,entrada,se cambio por A4,0.5,19.5,,
Papel bond 80 gramos tamaño oficio,Atlas,,,millar,2009-11-16,entrada,se cambio por A4,0.5,20,,
Papel bond 80 gramos tamaño oficio,Atlas,,,millar,2009-11-24,entrada,se cambio por A4,2,22,,
Papel bond 80 gramos tamaño oficio,Atlas,,,millar,2009-11-24,entrada,se cambio por A4,5,27,,
Papel bond 80 gramos tamaño oficio,Atlas,,,millar,2010-01-13,salida,se cambio por A4,1.5,25.5,,
Papel bond 80 gramos tamaño oficio,Atlas,,,millar,2010-01-22,salida,se cambio por A4,0.5,25,,
Papel bond 80 gramos tamaño oficio,Atlas,,,millar,2010-02-04,salida,14 millares a cambio por papel de la oficina de sec. General con resmas de 50x33x500 de 120 gramos,14,11,,
Papel bond 80 gramos tamaño oficio,Atlas,,,millar,2010-02-19,entrada,se cambio por A4,0.5,11.5,,
Papel bond 80 gramos tamaño oficio,Atlas,,,millar,2010-03-10,entrada,se cambio por A4,2,13.5,,
Papel bond 80 gramos tamaño oficio,Atlas,,,millar,2010-03-11,entrada,se cambio por A4,0.5,14,,
Papel bond 80 gramos tamaño oficio,Atlas,,,millar,2010-03-15,entrada,se cambio por A4,0.5,14.5,,
Papel bond 80 gramos tamaño oficio,Atlas,,,millar,2010-03-16,entrada,se cambio por A4,1,15.5,,
Papel bond 80 gramos tamaño oficio,Atlas,,,millar,2010-03-19,entrada,se cambio por A4,1,16.5,,
Papel bond 80 gramos tamaño oficio,Atlas,,,millar,2010-03-25,entrada,se cambio por A4,2,18.5,,
Papel bond 80 gramos tamaño oficio,Atlas,,,millar,2010-04-05,entrada,se cambio por A4,2,20.5,,
Papel bond 80 gramos tamaño oficio,Atlas,,,millar,2010-09-28,salida,1.5 millar planes estrategicos al 2016,1.5,19,,
Papel bond 80 gramos tamaño oficio,Atlas,,,millar,2010-12-20,salida,1 millar para uso de la oficina de publicaciones,1,18,,
Papel bond 80 gramos tamaño oficio,Atlas,,,millar,2011-02-25,entrada,se cambio por A4,1,19,,
Papel bond 80 gramos tamaño oficio,Atlas,,,millar,2011-03-11,entrada,se cambio por A4,0.5,19.5,,
Papel bond 80 gramos tamaño oficio,Atlas,,,millar,2011-04-13,entrada,se cambio por A4,1,20.5,,
Papel bond 80 gramos tamaño oficio,Atlas,,,millar,2011-05-09,entrada,se cambio por A4,2,22.5,,
Papel bond 80 gramos tamaño oficio,Atlas,,,millar,2011-05-11,entrada,se cambio por A4,2,24.5,,
Papel bond 80 gramos tamaño oficio,Atlas,,,millar,2011-07-04,entrada,se cambio por A4,0.5,25,,
Papel bond 80 gramos tamaño oficio,Atlas,,,millar,2011-08-18,entrada,se cambio por A4,3,28,,
Papel bond 80 gramos tamaño oficio,Atlas,,,millar,2011-09-02,entrada,se cambio por A4,0.5,28.5,,
Papel bond 80 gramos tamaño oficio,Atlas,,,millar,2011-09-21,salida,1 millar a cambio por TA4,1,27.5,,
Papel bond 80 gramos tamaño oficio,Atlas,,,millar,2011-09-28,entrada,se cambio por A4,0.5,28,,
Papel bond 80 gramos tamaño oficio,Atlas,,,millar,2011-09-30,entrada,se cambio por A4,0.5,28.5,,
Papel bond 80 gramos tamaño oficio,Atlas,,,millar,2011-10-14,entrada,1 1/2 millar cambio por TA4,1.5,30,,
Papel canson A3 110/115GR,CBIT,,,millar,2007-11-27,entrada,O/C 678,4000,4000,,
Papel canson A3 110/115GR,CBIT,,,millar,2008-11-07,salida,1/2 millar,500,3500,,
Papel canson A3 110/115GR,CBIT,,,millar,2008-11-18,salida,250 hojas,250,3250,,
Papel canson A3 110/115GR,CBIT,,,millar,2009-01-09,salida,750 hojas,750,2500,,
Papel couche brillante 115 gramos 69x89,EUROART PLUS,,paquetes de 250 hojas x 2 = 500 hojas,resma 69x89x500,2007-12-31,entrada,O/C 01149 2 paquetes x 2 de 250 hojas c/u,20,20,,
Papel couche brillante 115 gramos 69x89,EUROART PLUS,,paquetes de 250 hojas x 2 = 500 hojas,resma 69x89x500,2008-12-05,salida,plan institucional 08 1/2 resma,0.5,19.5,,
Papel couche brillante 115 gramos 69x89,EUROART PLUS,,paquetes de 250 hojas x 2 = 500 hojas,resma 69x89x500,2009-07-31,salida,tríptico unidad post grado fac. cs. Comunicación 1/2 R,0.5,19,,
Papel couche brillante 115 gramos 69x89,EUROART PLUS,,paquetes de 250 hojas x 2 = 500 hojas,resma 69x89x500,2009-12-11,salida,guia del estudiante (50) y HALCON (100) ,2,17,,
Papel couche brillante 115 gramos 69x89,EUROART PLUS,,paquetes de 250 hojas x 2 = 500 hojas,resma 69x89x500,2010-03-10,salida,completar 10 millares guias del estudiante 2008,3,14,,
Papel couche brillante 115 gramos 69x89,EUROART PLUS,,paquetes de 250 hojas x 2 = 500 hojas,resma 69x89x500,2010-03-29,salida,plan operativo 2010 memoria 2008,2.5,11.5,,
Papel couche brillante 115 gramos 69x89,EUROART PLUS,,paquetes de 250 hojas x 2 = 500 hojas,resma 69x89x500,2010-06-25,salida,convenio fundacion fraternitas univ triptico,2.5,9,,
Papel couche brillante 115 gramos 69x89,EUROART PLUS,,paquetes de 250 hojas x 2 = 500 hojas,resma 69x89x500,2010-12-07,salida,programas aniversario,1,8,,
Papel couche brillante 115 gramos 69x89,EUROART PLUS,,paquetes de 250 hojas x 2 = 500 hojas,resma x 125 hojas,2011-10-14,salida,1 resma para anuario estadistico 2010,1,7,,
Papel couche mate 150 gramos 72x102 ,,,,resma x 500 hojas,2011-08-10,entrada,5 resmas  ,2500,2500,277.15,1385.75
Papel couche mate 150 gramos 72x102 ,,,,resma x 500 hojas,2011-11-21,salida,52 hojas para afiches de acreditacion,52,2448,,
Papel couche mate 72x102 200 gramos,SUNBRITE,,,resma x 125 hojas,2011-07-27,entrada,5 resmas de 125 hojas ,625,625,70,350
Papel couche mate 72x102 200 gramos,SUNBRITE,,,resma x 125 hojas,2011-08-11,salida,50 hojas  ,50,575,,
Papel couche mate 72x102 200 gramos,SUNBRITE,,,resma x 125 hojas,2011-09-08,salida,13 hojas,13,562,,
Papel couche mate 72x102 200 gramos,SUNBRITE,,,resma x 125 hojas,2011-09-19,salida,6 hojas,6,556,,
Papel couche mate 72x102 200 gramos,SUNBRITE,,,resma x 125 hojas,2011-11-17,salida,20 hojas afiche del espejo de gandhi,20,536,,
Papel couche 300 gramos,,,,hoja cortada en 4,2007-01-31,entrada,500 hojas cortadas en 4,2000,2000,,
Papel couche 300 gramos,,,,hoja cortada en 4,2007-03-07,salida,tarjetas de invitación apertura del año académico,550,1450,,
Papel couche 300 gramos,,,,hoja cortada en 4,2007-03-15,salida,tarjetas de pensión post grado adm.,60,1390,,
Papel couche 300 gramos,,,,hoja cortada en 4,2007-03-16,salida,tarjetas de pensión post grado adm.,60,1330,,
Papel couche 300 gramos,,,,hoja cortada en 4,2007-05-11,salida,caratula plan de funcionamiento 2007,150,1180,,
Papel couche 300 gramos,,,,hoja cortada en 4,2007-07-31,salida,invitaciones y recuerdos inauguracion museo 2007,70,1100,,
Papel couche 300 gramos,,,,hoja cortada en 4,2007-08-21,salida,pasta nuevo reglamento de control ,400,700,,
Papel couche 300 gramos,,,,hoja cortada en 4,2008-01-15,salida,caratulas memoria 2006,150,550,,
Papel couche 300 gramos,,,,hoja cortada en 4,2008-03-19,salida,hojas para el calendario académico para docentes,150,400,,
Papel couche 300 gramos,,,,hoja cortada en 4,2010-04-23,salida,tarjetas dia de la secretaria y psicologo,100,300,,
Papel couche 300 gramos,,,,hoja cortada en 4,2010-05-05,salida,tarjetas del dia de la madre,160,140,,
Pasta suavizante,,,,kilo,2011-09-26,entrada,,3,3,22,66
Placas (chicas),Multilift,,,,2005-11-03,entrada,saldo,13,13,,
Placas (chicas),Multilift,,,,2007-01-24,salida,placa para prueba de revelados,1,12,,
Placas (chicas),Multilift,,,,2007-02-21,salida,bienestar formato visitas domiciliarias,1,11,,
Placas (chicas),Multilift,,,,2008-11-28,salida,,1,10,,
Placas metálicas CTP DIRECT INKJET PLATE 400x510x0.15,,,,unidad,2010-01-07,entrada,,100,100,,
Placas metálicas CTP DIRECT INKJET PLATE 400x510x0.15,,,,unidad,2010-06-25,salida,convenio fundacion fraternitas universales UNCP,4,96,,
Placas metálicas CTP DIRECT INKJET PLATE 400x510x0.15,,,,unidad,2010-07-02,salida,velo en una placa para el convenio fraternitas UNCP,1,95,,
Placas metálicas CTP DIRECT INKJET PLATE 400x510x0.15,,,,unidad,2010-07-06,salida,tripticos convenio fundacion fraternitas,4,91,,
Placas metálicas CTP DIRECT INKJET PLATE 400x510x0.15,,,,unidad,2010-07-08,salida,1 placa tripticos convenio fundacion fraternitas,1,90,,
Placas metálicas CTP DIRECT INKJET PLATE 400x510x0.15,,,,unidad,2010-07-08,salida,4 placas afiches grandes 36x51,4,86,,
Placas metálicas CTP DIRECT INKJET PLATE 400x510x0.15,,,,unidad,2010-07-21,salida,4 placas capacitación refuerzo con LINGRAF,4,82,,
Placas metálicas CTP DIRECT INKJET PLATE 400x510x0.15,,,,unidad,2010-07-22,salida,placas capacitacion LINGRAF,4,78,,
Placas metálicas CTP DIRECT INKJET PLATE 400x510x0.15,,,,unidad,2010-08-12,salida,4 placas membrete facultad de medicina,4,74,,
Placas metálicas CTP DIRECT INKJET PLATE 400x510x0.15,,,,unidad,2010-08-25,salida,8 placas cs. Comunicación y tramite documentario,8,66,,
Placas metálicas CTP DIRECT INKJET PLATE 400x510x0.15,,,,unidad,2010-10-20,salida,2 placas membrete memorandum oficina de tramite documentario,2,64,,
Placas metálicas CTP DIRECT INKJET PLATE 400x510x0.15,,,,unidad,2010-10-21,salida,2 placas membrete memorandum oficina de tramite documentario,2,62,,
Placas metálicas CTP DIRECT INKJET PLATE 400x510x0.15,,,,unidad,2010-10-28,entrada,pecosa PE 01757 200,200,262,461.16,922.32
Placas metálicas CTP DIRECT INKJET PLATE 400x510x0.15,,,,unidad,2010-11-16,salida,5 placas afiche semana de la calidad,5,257,,
Placas metálicas CTP DIRECT INKJET PLATE 400x510x0.15,,,,unidad,2010-11-18,salida,2 placas programa semana de la calidad,2,255,,
Placas metálicas CTP DIRECT INKJET PLATE 400x510x0.15,,,,unidad,2010-12-07,salida,5 placas programa aniversario,5,250,,
Placas metálicas CTP DIRECT INKJET PLATE 400x510x0.15,,,,unidad,2010-12-07,salida,3 placas invitaciones aniversario,3,247,,
Placas metálicas CTP DIRECT INKJET PLATE 400x510x0.15,,,,unidad,2010-12-14,salida,8 placas membretados mantenimiento y cooperación técnica,8,239,,
Placas metálicas CTP DIRECT INKJET PLATE 400x510x0.15,,,,unidad,2010-12-14,salida,2 placas membretados de la of. De cooperacion tecnica,2,237,,
Placas metálicas CTP DIRECT INKJET PLATE 400x510x0.15,,,,unidad,2010-12-20,salida,4 placas calendario cosmobiologico,4,233,,
Placas metálicas CTP DIRECT INKJET PLATE 400x510x0.15,,,,unidad,2011-01-26,salida,1 cuna reg. Academ.,1,232,,
Placas metálicas CTP DIRECT INKJET PLATE 400x510x0.15,,,,unidad,2011-03-14,salida,4 tarjetas de invitacion apertura año academico 2011,4,228,,
Placas metálicas CTP DIRECT INKJET PLATE 400x510x0.15,,,,unidad,2011-03-31,salida,2 placas para dar mantenimiento al equipo CTP por la empresa LINGRAF,2,226,,
Placas metálicas CTP DIRECT INKJET PLATE 400x510x0.15,,,,unidad,2011-04-01,salida,2 placas para dar mantenimiento al equipo CTP por la empresa LINGRAF,2,224,,
Placas metálicas CTP DIRECT INKJET PLATE 400x510x0.15,,,,unidad,2011-05-05,salida,4 placas tarjetas dia de la madre,4,220,,
Placas metálicas CTP DIRECT INKJET PLATE 400x510x0.15,,,,unidad,2011-05-09,salida,8 placas triptico orientacion vocacional zootecnia,8,212,,
Placas metálicas CTP DIRECT INKJET PLATE 400x510x0.15,,,,unidad,2011-05-09,salida,4 placas triptico membrete fac. medicina,4,208,,
Placas metálicas CTP DIRECT INKJET PLATE 400x510x0.15,,,,unidad,2011-05-11,salida,4 placas triptico investigacion feria ciencias orientacion vocacional,4,204,,
Placas metálicas CTP DIRECT INKJET PLATE 400x510x0.15,,,,unidad,2011-06-09,salida,1 placa para reemplazar placa fallada triptico zootecnia,1,203,,
Placas metálicas CTP DIRECT INKJET PLATE 400x510x0.15,,,,unidad,2011-07-08,salida,8 placas para el triptico de biblioteca,8,195,,
Placas metálicas CTP DIRECT INKJET PLATE 400x510x0.15,,,,unidad,2011-07-11,salida,2 placas para el triptico de biblioteca,2,193,,
Placas metálicas CTP DIRECT INKJET PLATE 400x510x0.15,,,,unidad,2011-08-09,salida,3 placas para tramite documentario notificacion,3,190,,
Placas metálicas CTP DIRECT INKJET PLATE 400x510x0.15,,,,unidad,2011-08-15,salida,4 placas para pastoral universitaria,4,186,,
Placas metálicas CTP DIRECT INKJET PLATE 400x510x0.15,,,,unidad,2011-09-22,salida,4 placas para triptico de biblioteca,4,182,,
Placas convencionales,,,,unidad,2006-11-15,entrada,O/C 1054,500,500,,
Placas convencionales,,,,unidad,2006-11-15,salida,placas prestadas de otros trabajos para revista de acreditación,6,494,,
Placas convencionales,,,,unidad,2006-11-23,salida,certificados de proyección social,1,493,,
Placas convencionales,,,,unidad,2006-11-27,salida,memoria 2004,38,455,,
Placas convencionales,,,,unidad,2006-12-06,salida,memoria 2004,3,452,,
Placas convencionales,,,,unidad,2006-12-12,salida,memoria 2005,83,369,,
Placas convencionales,,,,unidad,2006-12-12,salida,pasta memoria 2005,4,365,,
Placas convencionales,,,,unidad,2006-12-13,salida,tarjeta invitación aniversario XLVII,1,364,,
Placas convencionales,,,,unidad,2006-12-14,salida,tickets almuerzo aniversario,1,363,,
Placas convencionales,,,,unidad,2006-12-15,salida,papeletas de salida biblioteca,1,362,,
Placas convencionales,,,,unidad,2006-12-18,salida,para completar memoria 2005,5,357,,
Placas convencionales,,,,unidad,2006-12-18,salida,reemplazo de placas defectuosas memoria,4,353,,
Placas convencionales,,,,unidad,2006-12-19,salida,caratula memoria 2005,4,349,,
Placas convencionales,,,,unidad,2006-12-20,salida,tarjetas navideñas,4,345,,
Placas convencionales,,,,unidad,2006-12-21,salida,papeletas de permisos de horas extras,1,344,,
Placas convencionales,,,,unidad,2007-01-03,salida,membrete fac. ing. Civil e ing. Minas,8,336,,
Placas convencionales,,,,unidad,2007-01-05,salida,completar memoria 2005,7,329,,
Placas convencionales,,,,unidad,2007-01-08,salida,calendario academico 2007-I,1,328,,
Placas convencionales,,,,unidad,2007-01-09,salida,memoria 2005,3,325,,
Placas convencionales,,,,unidad,2007-01-10,salida,memoria 2005,1,324,,
Placas convencionales,,,,unidad,2007-01-23,salida,certificados de proyección social,1,323,,
Placas convencionales,,,,unidad,2007-01-24,salida,prospecto de admisión,200,123,,
Placas convencionales,,,,unidad,2007-01-27,salida,prospecto de admisión,23,100,,
Placas convencionales,,,,unidad,2007-01-28,salida,prospecto de admisión,11,89,,
Placas convencionales,,,,unidad,2007-01-29,salida,prospecto de admisión,3,86,,
Placas convencionales,,,,unidad,2007-01-30,salida,prospecto de admisión,16,70,,
Placas convencionales,,,,unidad,2007-01-31,salida,prospecto de admisión,4,66,,
Placas convencionales,,,,unidad,2007-01-31,salida,prospecto de admisión,66,0,,
Placas convencionales,,,,unidad,2007-01-31,entrada,O/C admisión 5 cajasx100 - O/C 00016,500,500,,
Placas convencionales,,,,unidad,2007-03-07,salida,tarjetas de invitación apertura del año académico,1,499,,
Placas convencionales,,,,unidad,2007-03-13,salida,fac. ing. Eléctrica modificar datos membrete,1,498,,
Placas convencionales,,,,unidad,2007-03-13,salida,transportes control salida vehiculos,1,497,,
Placas convencionales,,,,unidad,2007-03-13,salida,escuela post grado adm. Certific.,1,496,,
Placas convencionales,,,,unidad,2007-03-13,salida,escuela post grado adm. Tarjetas,2,494,,
Placas convencionales,,,,unidad,2007-04-10,salida,caratula empastado sec. General,1,493,,
Placas convencionales,,,,unidad,2007-04-11,salida,caratula empastado sec. General,1,492,,
Placas convencionales,,,,unidad,2007-04-23,salida,tickets bienestar universitario (comedor),3,489,,
Placas convencionales,,,,unidad,2007-05-11,salida,pasta del plan de funcionamiento 2007,4,485,,
Placas convencionales,,,,unidad,2007-05-14,salida,contenido del plan de funcionamiento 2007,85,400,,
Placas convencionales,,,,unidad,2007-05-18,salida,plan de funcionamiento 2007,20,380,,
Placas convencionales,,,,unidad,2007-05-23,salida,plan de funcionamiento 2007,21,359,,
Placas convencionales,,,,unidad,2007-06-04,salida,caratulas de auditoria (uno nuevo),1,358,,
Placas convencionales,,,,unidad,2007-06-18,salida,certificado medico,1,357,,
Placas convencionales,,,,unidad,2007-06-19,salida,certificado medico,1,356,,
Placas convencionales,,,,unidad,2007-06-20,salida,hoja trabajo auditoria,1,355,,
Placas convencionales,,,,unidad,2007-06-26,salida,tickets comedor universitario,1,354,,
Placas convencionales,,,,unidad,2007-07-09,salida,etiquetas biblioteca,1,353,,
Placas convencionales,,,,unidad,2007-07-17,salida,tickets para víveres,6,347,,
Placas convencionales,,,,unidad,2007-07-19,salida,mosquitos museo,1,346,,
Placas convencionales,,,,unidad,2007-07-23,salida,adicional víveres,1,345,,
Placas convencionales,,,,unidad,2007-07-23,salida,post grado biptico industrias alimentarias,4,341,,
Placas convencionales,,,,unidad,2007-07-24,salida,post grado biptico industrias alimentarias,1,340,,
Placas convencionales,,,,unidad,2007-07-30,salida,bipticos invitaciones y recuerdos museo,8,332,,
Placas convencionales,,,,unidad,2007-07-31,salida,bipticos museo,1,331,,
Placas convencionales,,,,unidad,2007-08-17,salida,tickets museo,3,328,,
Placas convencionales,,,,unidad,2007-08-20,salida,reglamento de asistencia,10,318,,
Placas convencionales,,,,unidad,2007-08-20,salida,reglamento de asistencia,1,317,,
Placas convencionales,,,,unidad,2007-08-21,salida,tickets museo retira,2,315,,
Placas convencionales,,,,unidad,2007-08-21,salida,pastas nuevo reglamento control,4,311,,
Placas convencionales,,,,unidad,2007-09-03,salida,solicitud y ficha de inscripción comedor bienestar,3,308,,
Placas convencionales,,,,unidad,2007-09-04,salida,ficha informativa sobre soborno,4,304,,
Placas convencionales,,,,unidad,2007-09-04,salida,4 placas ,4,300,,
Placas convencionales,,,,unidad,2007-09-06,salida,7 placas documentos departamento psicología,3,297,,
Placas convencionales,,,,unidad,2007-09-07,salida,4 placas para 250 certificados asamblea univ.,8,289,,
Placas convencionales,,,,unidad,2007-09-07,salida,4 placas para tarjetas personales autoridades,4,285,,
Placas convencionales,,,,unidad,2007-09-10,salida,1 placa para el calendario académico,1,284,,
Placas convencionales,,,,unidad,2007-09-19,salida,1 placa registros - CUNA,1,283,,
Placas convencionales,,,,unidad,2007-10-24,salida,2 placas para examenes fac. metalurgia,2,281,,
Placas convencionales,,,,unidad,2007-11-19,salida,1 placa para membrete rectorado (cambiar datos negro),1,280,,
Placas convencionales,,,,unidad,2007-11-23,salida,1 placa para membrete de secretaria general,1,279,,
Placas convencionales,,,,unidad,2007-11-29,entrada,5 cajas O/C 705 PE 01696,500,779,,
Placas convencionales,,,,unidad,2007-12-04,salida,4 placas tripticos sociología,4,775,,
Placas convencionales,,,,unidad,2007-12-04,salida,4 placas afiches sociología,4,771,,
Placas convencionales,,,,unidad,2007-12-04,salida,2 placas falladas tripticos sociología,2,769,,
Placas convencionales,,,,unidad,2007-12-19,salida,4 placas tarjetas navideñas 2007,4,765,,
Placas convencionales,,,,unidad,2007-12-19,salida,1 caja + 3 placas para memoria 2006 (salida),103,662,,
Placas convencionales,,,,unidad,2007-12-28,salida,1 placa certificados sociologia mesa redonda,1,661,,
Placas convencionales,,,,unidad,2007-12-28,salida,2 placas tripticos sociología mesa redonda,2,659,,
Placas convencionales,,,,unidad,2007-12-28,salida,1 placa ticket almuerzo aniversario,1,658,,
Placas convencionales,,,,unidad,2007-12-28,salida,1 placa folder asesoria legal,1,657,,
Placas convencionales,,,,unidad,2008-01-07,salida,8 placas completar memoria 2006,8,649,,
Placas convencionales,,,,unidad,2008-02-08,salida,2 placas calendario academico 2008,2,647,,
Placas convencionales,,,,unidad,2008-02-14,salida,1 placa membrete zootecnia,1,646,,
Placas convencionales,,,,unidad,2008-02-15,salida,1 placa membrete vice rectorado académico,1,645,,
Placas convencionales,,,,unidad,2008-02-15,salida,1 placa membrete de asesoria legal,1,644,,
Placas convencionales,,,,unidad,2008-02-22,salida,1 placa sobres asesoria legal,1,643,,
Placas convencionales,,,,unidad,2008-02-29,salida,1 placa secretaria general membrete,1,642,,
Placas convencionales,,,,unidad,2008-03-04,salida,4 placas tarjetas dia de la mujer,4,638,,
Placas convencionales,,,,unidad,2008-03-07,salida,2 placas declaracion jurada bienestar,2,636,,
Placas convencionales,,,,unidad,2008-03-12,salida,4 placas para declaraciones juradas bienestar,4,632,,
Placas convencionales,,,,unidad,2008-03-13,salida,1 placa para tarjeta apertura año academico 2008,1,631,,
Placas convencionales,,,,unidad,2008-03-19,salida,4 placas nuevo membrete auditoria,4,627,,
Placas convencionales,,,,unidad,2008-03-25,salida,4 placas nuevo certificado de estudio,4,623,,
Placas convencionales,,,,unidad,2008-03-26,salida,4 placas calendario apertura año academico 2008 - I,4,619,,
Placas convencionales,,,,unidad,2008-03-28,salida,16 placas para membrete RES 02195-CJ-08,16,603,,
Placas convencionales,,,,unidad,2008-04-07,salida,12 placas para membrete RN 02195-CJ-08,12,591,,
Placas convencionales,,,,unidad,2008-04-08,salida,4 placas membrete fac. zootecnia,4,587,,
Placas convencionales,,,,unidad,2008-04-09,salida,4 placas membrete fac. contabilidad,4,583,,
Placas convencionales,,,,unidad,2008-04-11,salida,4 placas membrete rectorado,4,579,,
Placas convencionales,,,,unidad,2008-04-16,salida,"20 placas membrete agronomía, antrop., arq., cccc forestales",20,559,,
Placas convencionales,,,,unidad,2008-04-29,salida,2 placas comedor formato de requerimientos de impresiones,2,557,,
Placas convencionales,,,,unidad,2008-04-29,salida,2 placas ,2,555,,
Placas convencionales,,,,unidad,2008-05-06,salida,4 placas tarjetas día de la madre,4,551,,
Placas convencionales,,,,unidad,2008-05-12,salida,4 placas triptico fac. minas aniversario,4,547,,
Placas convencionales,,,,unidad,2008-05-16,salida,1 placa fac. sociología certificado practicas,1,546,,
Placas convencionales,,,,unidad,2008-05-28,salida,8 placas fac. sistemas,8,538,,
Placas convencionales,,,,unidad,2008-06-03,salida,3 placas tickets comedor y kardex,3,535,,
Placas convencionales,,,,unidad,2008-06-05,salida,3 placas certificado de estudios antiguo,3,532,,
Placas convencionales,,,,unidad,2008-06-11,salida,4 placas tarjeta dia del padre,4,528,,
Placas convencionales,,,,unidad,2008-06-16,salida,5 placas membrete asesoria legal,5,523,,
Placas convencionales,,,,unidad,2008-06-17,salida,1 placa reemplazar 1 placa membrete de secretaria general,1,522,,
Placas convencionales,,,,unidad,2008-06-30,salida,5 placas membrete vice rectorado academico y CUNA (registros academicos),5,517,,
Placas convencionales,,,,unidad,2008-07-01,salida,1 placa,1,516,,
Placas convencionales,,,,unidad,2008-07-07,salida,"16 placas para membrete vice. Rec, adm, antrop, arq",16,500,,
Placas convencionales,,,,unidad,2008-07-16,salida,"9 placas membrete cs comunicación, enfermeria, medicina",9,491,,
Placas convencionales,,,,unidad,2008-07-23,salida,"16 placas membrete trabsc, PPHH, tarma, ing. Civil",16,475,,
Placas convencionales,,,,unidad,2008-07-23,salida,4 placas membretes mecanica,4,471,,
Placas convencionales,,,,unidad,2008-07-30,salida,1 placa membrete calendario academico,1,470,,
Placas convencionales,,,,unidad,2008-08-07,salida,"5 placas curso taller archivo, tripticos y certificados",5,465,,
Placas convencionales,,,,unidad,2008-08-12,salida,2 placas certificado sociologia,2,463,,
Placas convencionales,,,,unidad,2008-08-19,salida,2 placas membrete secretaria general,2,461,,
Placas convencionales,,,,unidad,2008-08-20,salida,4 placas membrete resoluciones sec. General,4,457,,
Placas convencionales,,,,unidad,2008-08-21,salida,2 placas para papeletas de pedido libros biblioteca,2,455,,
Placas convencionales,,,,unidad,2008-08-21,salida,1 placa para papeleta de salida de personal,1,454,,
Placas convencionales,,,,unidad,2008-09-12,salida,1 placa certificado proyección social docentes,1,453,,
Placas convencionales,,,,unidad,2008-09-25,salida,1 placa reemplazar color amarillo ,1,452,,
Placas convencionales,,,,unidad,2008-09-30,salida,1 placa reemplazar magenta certificado de estudios,1,451,,
Placas convencionales,,,,unidad,2008-10-07,salida,1 placa reemplazar negro certificado de estudios,1,450,,
Placas convencionales,,,,unidad,2008-10-29,salida,50 placas memoria 2007,50,400,,
Placas convencionales,,,,unidad,2008-11-11,salida,100 placas memoria 2007 y plan de funcionamiento 2008,100,300,,
Placas convencionales,,,,unidad,2008-11-12,salida,2 placas memoria 2007,2,298,,
Placas convencionales,,,,unidad,2008-11-14,salida,4 placas memoria 2007,4,294,,
Placas convencionales,,,,unidad,2008-11-19,salida,60 placas plan operativo institucional,60,234,,
Placas convencionales,,,,unidad,2008-11-19,salida,34 placas revista investigación,34,200,,
Placas convencionales,,,,unidad,2008-12-09,salida,4 placas revista investigación,4,196,,
Placas convencionales,,,,unidad,2008-12-09,salida,6 placas tarjetas navideñas,6,190,,
Placas convencionales,,,,unidad,2008-12-10,salida,2 placas investigación,2,188,,
Placas convencionales,,,,unidad,2008-12-31,salida,4 placas membretado oficina de abastecimientos,4,184,,
Placas convencionales,,,,unidad,2009-01-16,salida,2 mosquitos y calendario académico 2009-I,2,182,,
Placas convencionales,,,,unidad,2009-02-05,salida,"1 placa RRHH, medica bienestar",1,181,,
Placas convencionales,,,,unidad,2009-02-16,salida,1 placa folder asesoria legal,1,180,,
Placas convencionales,,,,unidad,2009-02-20,salida,1 placa acta subsanación registros académicos,1,179,,
Placas convencionales,,,,unidad,2009-02-26,salida,140 placas membretados,140,39,,
Placas convencionales,,,,unidad,2009-03-10,salida,2 placas ficha socioeconómica bienestar,2,37,,
Placas convencionales,,,,unidad,2009-03-12,salida,2 placas triptico area sociologia bienestar,2,35,,
Placas convencionales,,,,unidad,2009-03-24,salida,1 placa tarjetas inauguración año académico 2009,1,34,,
Placas convencionales,,,,unidad,2009-03-24,salida,1 placa tarjetas de impresión inauguración año académico,1,33,,
Placas convencionales,,,,unidad,2009-03-25,salida,4 placas membrete oficina,4,29,,
Placas convencionales,,,,unidad,2009-04-01,salida,1 placa para membretado asesoria legal,1,28,,
Placas convencionales,,,,unidad,2009-04-22,salida,4 placas para tarjetas de secretaria,4,24,,
Placas convencionales,,,,unidad,2009-05-12,salida,5 placas certificados estudios post grado,5,19,,
Placas convencionales,,,,unidad,2009-05-21,entrada,O/C 0298 500 placas,500,519,,
Placas convencionales,,,,unidad,2009-06-04,salida,3 placas hoja evaluación organo control y papeleta de salida,3,516,,
Placas convencionales,,,,unidad,2009-06-10,salida,4 placas renovacion placas membrete secretaria general,4,512,,
Placas convencionales,,,,unidad,2009-06-15,salida,4 placas para los certificados de proyección social,4,508,,
Placas convencionales,,,,unidad,2009-07-08,salida,1 placa folder auditoria,1,507,,
Placas convencionales,,,,unidad,2009-07-08,salida,1 placa membrete fac. economía,1,506,,
Placas convencionales,,,,unidad,2009-07-13,salida,1 placa calendario académico 2009 - II,1,505,,
Placas convencionales,,,,unidad,2009-07-21,salida,1 placa membrete auditoria,1,504,,
Placas convencionales,,,,unidad,2009-07-21,salida,1 placa membrete auditoria,1,503,,
Placas convencionales,,,,unidad,2009-08-03,salida,1 placa membrete abastecimientos,1,502,,
Placas convencionales,,,,unidad,2009-08-31,salida,1 placa kardex almacen,1,501,,
Placas convencionales,,,,unidad,2009-11-09,salida,1 placa triptico comité electoral,1,500,,
Placas convencionales,,,,unidad,2009-12-10,salida,1 placa agenda 2010,1,499,,
Placas convencionales,,,,unidad,2009-12-17,salida,1 prueba para impresora de placas,1,498,,
Placas convencionales,,,,unidad,2009-12-17,salida,1 prueba para impresora de placas,1,497,,
Placas convencionales,,,,unidad,2009-12-29,salida,6 interiores de la guia del estudiante,6,491,,
Placas convencionales,,,,unidad,2010-01-13,salida,1 certificados fac. sociología,1,490,,
Placas convencionales,,,,unidad,2010-01-15,salida,"8 membretes nuevos datos rectorado, vice rectorado",8,482,,
Placas convencionales,,,,unidad,2010-01-26,salida,8 formatos y membretes centro medico y auditoria,8,474,,
Placas convencionales,,,,unidad,2010-02-03,salida,3 placas membretado sec. General y RRPP y ficha de bienestar,3,471,,
Placas convencionales,,,,unidad,2010-02-04,salida,1 placa ficha de bienestar,1,470,,
Placas convencionales,,,,unidad,2010-02-12,salida,6 placas guia estudiante,6,464,,
Placas convencionales,,,,unidad,2010-03-15,salida,1 placa apertura año académico,1,463,,
Placas convencionales,,,,unidad,2010-03-25,salida,1 placa membrete fac. ing. Industrias,1,462,,
Placas convencionales,,,,unidad,2010-04-07,salida,"trabajos bienestar centro medico, planta huari, transportes",12,450,,
Placas convencionales,,,,unidad,2010-04-07,salida,papeleta de salida oficina de empleo y desarrollo,1,449,,
Placas convencionales,,,,unidad,2010-04-08,salida,planta yauris formatos,2,447,,
Placas convencionales,,,,unidad,2010-04-15,salida,censo universitario,1,446,,
Placas convencionales,,,,unidad,2010-04-19,salida,4 membretes oficina general de mantenimiento y fac. enfermeria,4,442,,
Placas convencionales,,,,unidad,2010-04-23,salida,5 tarjetas dia de la secretaria y psicologia y correcion censo,5,437,,
Placas convencionales,,,,unidad,2010-04-28,salida,4 placas membretado fac. economia,4,433,,
Placas convencionales,,,,unidad,2010-04-29,salida,1 placa tarjetas dia del trabajo,1,432,,
Placas convencionales,,,,unidad,2010-05-06,salida,5 placas tarjetas dia de la madre y membrete proyección social,5,427,,
Placas convencionales,,,,unidad,2010-05-21,salida,2 placas triptico CENGAP,2,425,,
Placas convencionales,,,,unidad,2010-06-01,salida,"9 placas CONCAP, centro medico, membre v. acad.",9,416,,
Placas convencionales,,,,unidad,2010-06-03,salida,4 placas certificados de estudios,4,412,,
Placas convencionales,,,,unidad,2010-06-04,salida,1 placa membrete vice. Rec. Acad.,1,411,,
Placas convencionales,,,,unidad,2010-06-08,salida,1 placa facultad zootecnia,1,410,,
Placas convencionales,,,,unidad,2010-06-18,salida,5 placas tarjetas dia del padre,5,405,,
Placas convencionales,,,,unidad,2010-06-23,salida,3 placas pruebas con CTP INKJET mantenimiento,3,402,,
Placas convencionales,,,,unidad,2010-07-22,salida,1 placa sec. General membrete,1,401,,
Placas convencionales,,,,unidad,2010-08-03,salida,5 placas bienestar universitario,5,396,,
Placas convencionales,,,,unidad,2010-08-25,salida,2 placas hojas tramite documentario,2,394,,
Placas convencionales,,,,unidad,2010-09-03,salida,1 placa membrete tramite documentario,1,393,,
Placas convencionales,,,,unidad,2010-10-15,salida,4 placas membrete fac. zootecnia,4,389,,
Placas convencionales,,,,unidad,2010-11-15,salida,2 pruebas calibración impresora fotolitos,2,387,,
Placas convencionales,,,,unidad,2011-01-05,salida,1 membrete fac. trabajo social,1,386,,
Placas convencionales,,,,unidad,2011-01-14,salida,2 CUNA registros académicos,2,384,,
Placas convencionales,,,,unidad,2011-01-26,salida,1 membrete trámite documentario,1,383,,
Placas convencionales,,,,unidad,2011-01-28,salida,1 membrete trámite documentario,1,382,,
Placas convencionales,,,,unidad,2011-02-04,salida,2 membretes facultad enfermería y contabilidad cambio de datos,2,380,,
Placas convencionales,,,,unidad,2011-02-04,salida,1 membrete facultad mec.,1,379,,
Placas convencionales,,,,unidad,2011-02-17,salida,1 placa membrete sec. General,1,378,,
Placas convencionales,,,,unidad,2011-03-21,salida,1 placa membrete fac. administración,1,377,,
Placas convencionales,,,,unidad,2011-04-01,salida,1 placa CTP mantenimiento,1,376,,
Placas convencionales,,,,unidad,2011-04-07,salida,1 placa CTP mantenimiento,1,375,,
Placas convencionales,,,,unidad,2011-04-15,salida,4 fac. forestales membrete encuesta personal,4,371,,
Placas convencionales,,,,unidad,2011-06-10,salida,1 papeleta de pedido de libros y otros biblioteca,1,370,,
Placas convencionales,,,,unidad,2011-06-28,salida,1 formato sociología,1,369,,
Placas convencionales,,,,unidad,2011-06-28,salida,1 formato sociología,1,368,,
Placas convencionales,,,,unidad,2011-09-09,salida,1 certificados enfermería,1,367,,
Placas convencionales,,,,unidad,2011-09-25,salida,1 corrección dirección membrete proyección social,1,366,,
Placas convencionales,,,,unidad,2011-09-19,salida,1 corregir dirección membrete ing. Civil,1,365,,
Placas convencionales,,,,unidad,2011-10-10,salida,1 placa papeleta de salida,1,364,,
Placas convencionales,,,,unidad,2011-10-12,salida,formato de CUNA,1,363,,
Placas convencionales,,,,unidad,2011-10-14,salida,membrete de metalurgia y de quimica,2,361,,
Placas convencionales,,,,unidad,2011-10-28,salida,3 placas,3,358,,
Placas convencionales,,,,unidad,2011-11-21,salida,cedulas comité electoral,1,357,,
Placas convencionales,,,,unidad,2011-12-05,salida,placa folderes de auditoria,1,356,,
Placas convencionales,,,,unidad,2011-12-07,salida,1 placa,1,355,,
Placas convencionales,,,,unidad,2011-12-13,salida,3 placas invitaciones ceremonia aniversario,5,350,,
Plate cleaner k limpiador y activador de placas (litho emulsion),hostmann,,,litros,2005-09-14,entrada,O/C 907,100,100,,
Plate cleaner k limpiador y activador de placas (litho emulsion),hostmann,,,litros,2005-11-03,salida,,1,99,,
Plate cleaner k limpiador y activador de placas (litho emulsion),hostmann,,,litros,2005-11-21,salida,,1,98,,
Plate cleaner k limpiador y activador de placas (litho emulsion),hostmann,,,litros,2006-01-03,salida,,1,97,,
Plate cleaner k limpiador y activador de placas (litho emulsion),hostmann,,,litros,2006-06-27,salida,,1,96,,
Plate cleaner k limpiador y activador de placas (litho emulsion),hostmann,,,litros,2006-07-24,salida,,1,95,,
Plate cleaner k limpiador y activador de placas (litho emulsion),hostmann,,,litros,2006-08-07,salida,,1,94,,
Plate cleaner k limpiador y activador de placas (litho emulsion),hostmann,,,litros,2006-09-13,salida,,1,93,,
Plate cleaner k limpiador y activador de placas (litho emulsion),hostmann,,,litros,2006-09-25,salida,,1,92,,
Plate cleaner k limpiador y activador de placas (litho emulsion),hostmann,,,litros,2006-10-02,salida,,1,91,,
Plate cleaner k limpiador y activador de placas (litho emulsion),hostmann,,,litros,2006-11-10,salida,,1,90,,
Plate cleaner k limpiador y activador de placas (litho emulsion),hostmann,,,litros,2007-01-03,salida,,1,89,,
Plate cleaner k limpiador y activador de placas (litho emulsion),hostmann,,,litros,2007-01-24,salida,,1,88,,
Plate cleaner k limpiador y activador de placas (litho emulsion),hostmann,,,litros,2007-01-28,salida,,1,87,,
Plate cleaner k limpiador y activador de placas (litho emulsion),hostmann,,,litros,2007-02-01,salida,,1,86,,
Plate cleaner k limpiador y activador de placas (litho emulsion),hostmann,,,litros,2007-04-02,salida,,1,85,,
Plate cleaner k limpiador y activador de placas (litho emulsion),hostmann,,,litros,2007-05-18,salida,,1,84,,
Plate cleaner k limpiador y activador de placas (litho emulsion),hostmann,,,litros,2007-07-10,salida,,1,83,,
Plate cleaner k limpiador y activador de placas (litho emulsion),hostmann,,,litros,2007-09-11,salida,,1,82,,
Plate cleaner k limpiador y activador de placas (litho emulsion),hostmann,,,litros,2007-11-23,salida,,1,81,,
Plate cleaner k limpiador y activador de placas (litho emulsion),hostmann,,,litros,2008-04-07,salida,,1,80,,
Plate cleaner k limpiador y activador de placas (litho emulsion),hostmann,,,litros,2008-06-06,salida,,1,79,,
Plate cleaner k limpiador y activador de placas (litho emulsion),hostmann,,,litros,2008-08-01,salida,,1,78,,
Plate cleaner k limpiador y activador de placas (litho emulsion),hostmann,,,litros,2008-09-16,salida,,1,77,,
Plate cleaner k limpiador y activador de placas (litho emulsion),hostmann,,,litros,2008-12-05,salida,,1,76,,
Plate cleaner k limpiador y activador de placas (litho emulsion),hostmann,,,litros,2008-12-23,salida,,1,75,,
Plate cleaner k limpiador y activador de placas (litho emulsion),hostmann,,,litros,2009-02-05,salida,,1,74,,
Plate cleaner k limpiador y activador de placas (litho emulsion),hostmann,,,litros,2009-03-25,salida,,1,73,,
Plate cleaner k limpiador y activador de placas (litho emulsion),hostmann,,,litros,2009-04-08,salida,,1,72,,
Plate cleaner k limpiador y activador de placas (litho emulsion),hostmann,,,litros,2009-04-21,salida,,1,71,,
Plate cleaner k limpiador y activador de placas (litho emulsion),hostmann,,,litros,2009-06-10,salida,,1,70,,
Plate cleaner k limpiador y activador de placas (litho emulsion),hostmann,,,litros,2009-07-03,salida,,1,69,,
Plate cleaner k limpiador y activador de placas (litho emulsion),hostmann,,,litros,2009-07-24,salida,,1,68,,
Plate cleaner k limpiador y activador de placas (litho emulsion),hostmann,,,litros,2009-08-28,salida,,1,67,,
Plate cleaner k limpiador y activador de placas (litho emulsion),hostmann,,,litros,2009-09-03,salida,,1,66,,
Plate cleaner k limpiador y activador de placas (litho emulsion),hostmann,,,litros,2009-09-15,salida,,1,65,,
Plate cleaner k limpiador y activador de placas (litho emulsion),hostmann,,,litros,2009-09-23,salida,,1,64,,
Plate cleaner k limpiador y activador de placas (litho emulsion),hostmann,,,litros,2009-10-02,salida,,1,63,,
Plate cleaner k limpiador y activador de placas (litho emulsion),hostmann,,,litros,2009-10-12,salida,,1,62,,
Plate cleaner k limpiador y activador de placas (litho emulsion),hostmann,,,litros,2009-10-14,salida,,1,61,,
Plate cleaner k limpiador y activador de placas (litho emulsion),hostmann,,,litros,2009-12-07,salida,,1,60,,
Plate cleaner k limpiador y activador de placas (litho emulsion),hostmann,,,litros,2009-12-30,salida,,1,59,,
Plate cleaner k limpiador y activador de placas (litho emulsion),hostmann,,,litros,2010-01-22,salida,,1,58,,
Plate cleaner k limpiador y activador de placas (litho emulsion),hostmann,,,litros,2010-02-16,salida,,1,57,,
Plate cleaner k limpiador y activador de placas (litho emulsion),hostmann,,,litros,2010-03-01,salida,,1,56,,
Plate cleaner k limpiador y activador de placas (litho emulsion),hostmann,,,litros,2010-04-05,salida,,1,55,,
Plate cleaner k limpiador y activador de placas (litho emulsion),hostmann,,,litros,2010-04-14,salida,,1,54,,
Plate cleaner k limpiador y activador de placas (litho emulsion),hostmann,,,litros,2010-05-26,salida,,1,53,,
Plate cleaner k limpiador y activador de placas (litho emulsion),hostmann,,,litros,2010-06-04,salida,,1,52,,
Plate cleaner k limpiador y activador de placas (litho emulsion),hostmann,,,litros,2010-07-13,salida,,1,51,,
Plate cleaner k limpiador y activador de placas (litho emulsion),hostmann,,,litros,2010-08-16,salida,,1,50,,
Plate cleaner k limpiador y activador de placas (litho emulsion),hostmann,,,litros,2010-08-26,salida,,1,49,,
Plate cleaner k limpiador y activador de placas (litho emulsion),hostmann,,,litros,2010-09-02,salida,,1,48,,
Plate cleaner k limpiador y activador de placas (litho emulsion),hostmann,,,litros,2010-09-15,salida,,1,47,,
Plate cleaner k limpiador y activador de placas (litho emulsion),hostmann,,,litros,2010-10-27,salida,,1,46,,
Plate cleaner k limpiador y activador de placas (litho emulsion),hostmann,,,litros,2010-11-02,salida,,1,45,,
Plate cleaner k limpiador y activador de placas (litho emulsion),hostmann,,,litros,2011-01-26,salida,,1,44,,
Plate cleaner k limpiador y activador de placas (litho emulsion),hostmann,,,litros,2011-02-15,salida,,1,43,,
Plate cleaner k limpiador y activador de placas (litho emulsion),hostmann,,,litros,2011-02-21,salida,,1,42,,
Plate cleaner k limpiador y activador de placas (litho emulsion),hostmann,,,litros,2011-05-06,salida,,1,41,,
Plate cleaner k limpiador y activador de placas (litho emulsion),hostmann,,,litros,2011-08-16,salida,,1,40,,
Plate cleaner k limpiador y activador de placas (litho emulsion),hostmann,,,litros,2011-10-05,salida,,1,39,,
Percalina,,,,metros,2007-09-17,entrada,O/C 676,250,250,,
Percalina,,,,metros,2009-11-16,salida,trabajos de empastados a las 200 diferentes facultades y oficinas por registro de producción,200,50,,
Percalina,,,,metros,2009-11-17,entrada,,700,750,,
Polvo antirepinte,hostmann,,,kilos,2006-06-02,entrada,O/C 982,3,3,,
Polvo antirepinte,hostmann,,,kilos,2005-11-03,entrada,obsequio de heidelberg 0.750 gramos,0.75,3.75,,
Polvo antirepinte,hostmann,,,kilos,2006-09-26,salida,,0.25,3.5,,
Revelador de placas,,44515215,,galón,2004-12-30,entrada,O/C 1029 - PE 01461,1,1,,
Revelador de placas,,44515215,,galón,2005-03-10,salida,,1,0,,
Revelador de placas,,44515215,,galón,2005-05-17,entrada,O/C 197,3,3,,
Revelador de placas,,44515215,,galón,2005-11-03,salida,,1,2,,
Revelador de placas,,44515215,,galón,2006-09-13,salida,,0.5,1.5,,
Revelador de placas,,44515215,,galón,2006-09-21,salida,,0.25,1.25,,
Revelador de placas,,44515215,,galón,2006-12-01,salida,,0.25,1,,
Revelador de placas,,44515215,,galón,2006-12-14,salida,,0.25,0.75,,
Revelador de placas,,44515215,,galón,2006-12-15,salida,,0.25,0.5,,
Revelador de placas,,44515215,,galón,2007-01-08,salida,,0.25,0.25,,
Revelador de placas,,44515215,,galón,2007-01-24,salida,,0.25,0,,
Revelador de placas,,44515215,,galón,2007-02-28,entrada,O/C 00016,2,2,,
Revelador de placas,,44515215,,galón,2007-02-28,salida,,1,1,,
Revelador de placas,,44515215,,galón,2007-05-18,salida,,0.25,0.75,,
Revelador de placas,,44515215,,galón,2007-07-23,salida,,0.25,0.5,,
Revelador de placas,,44515215,,galón,2007-08-20,salida,,0.25,0.25,,
Revelador de placas,,44515215,,galón,2007-09-06,salida,,0.1,0.15,,
Revelador de placas,,44515215,,galón,2007-11-27,entrada,O/C 523,3,3.15,,
Revelador de placas,,44515215,,galón,2007-12-01,salida,tripticos sociologia,0.05,3.1,,
Revelador de placas,,44515215,,galón,2007-12-10,salida,memoria 2006,0.1,3,,
Revelador de placas,,44515215,,galón,2008-03-12,salida,,0.1,2.9,,
Revelador de placas,,44515215,,galón,2008-03-31,salida,,0.1,2.8,,
Revelador de placas,,44515215,,galón,2008-04-07,salida,,0.1,2.7,,
Revelador de placas,,44515215,,galón,2008-04-15,salida,,0.1,2.6,,
Revelador de placas,,44515215,,galón,2008-05-21,salida,,0.1,2.5,,
Revelador de placas,,44515215,,galón,2008-06-16,salida,,0.1,2.4,,
Revelador de placas,,44515215,,galón,2008-07-24,salida,,0.1,2.3,,
Revelador de placas,,44515215,,galón,2008-08-13,salida,,0.1,2.2,,
Revelador de placas,,44515215,,galón,2008-08-21,salida,,0.1,2.1,,
Revelador de placas,,44515215,,galón,2008-11-10,salida,,0.05,2.05,,
Revelador de placas,,44515215,,galón,2008-12-09,salida,,0.05,2,,
Revelador de placas,,44515215,,galón,2009-08-03,salida,,1,1,,
Revelador de placas,,44515215,,galón,2010-04-20,salida,,1,0,,
Revelador de placas,,44515215,,galón,2010-10-20,entrada,PE 01757 40 litros,40,40,36,180
Revelador de placas,,44515215,,galón,2011-05-10,salida,,4,36,,
Revelador de placas,,44515215,,galón,2011-10-10,salida,,4,32,,
Solución de fuente DIRECT FLUIA,hostmann,,,bidón x 10 kilos,2006-06-02,entrada,O/C 982,10,10,,
Solución de fuente DIRECT FLUIA,hostmann,,,bidón x 10 kilos,2006-11-03,salida,,1,9,,
Solución de fuente DIRECT FLUIA,hostmann,,,bidón x 10 kilos,2005-12-15,salida,,2,7,,
Solución de fuente DIRECT FLUIA,hostmann,,,bidón x 10 kilos,2006-05-16,salida,,2,5,,
Solución de fuente DIRECT FLUIA,hostmann,,,bidón x 10 kilos,2006-06-01,salida,,2,3,,
Solución de fuente DIRECT FLUIA,hostmann,,,bidón x 10 kilos,2007-01-18,salida,,1,2,,
Solución de fuente DIRECT FLUIA,hostmann,,,bidón x 10 kilos,2007-01-24,salida,,0.5,1.5,,
Solución de fuente DIRECT FLUIA,hostmann,,,bidón x 10 kilos,2007-01-27,salida,,1,0.5,,
Solución de fuente DIRECT FLUIA,hostmann,,,bidón x 10 kilos,2007-02-20,salida,,0.25,0.25,,
Solución de fuente DIRECT FLUIA,hostmann,,,bidón x 10 kilos,2007-07-26,entrada,O/C 00527,10,10.25,,
Solución de fuente DIRECT FLUIA,hostmann,,,bidón x 10 kilos,2008-01-04,salida,,0.25,10,,
Solución de fuente DIRECT FLUIA,hostmann,,,bidón x 10 kilos,2008-02-18,salida,,0.35,9.65,,
Solución de fuente DIRECT FLUIA,hostmann,,,bidón x 10 kilos,2008-03-25,salida,,0.35,9.3,,
Solución de fuente DIRECT FLUIA,hostmann,,,bidón x 10 kilos,2008-04-18,salida,,0.45,8.85,,
Solución de fuente DIRECT FLUIA,hostmann,,,bidón x 10 kilos,2008-05-29,entrada,O/C 00331,20,28.85,,
Solución de fuente DIRECT FLUIA,hostmann,,,bidón x 10 kilos,2008-06-02,salida,,1.05,27.8,,
Solución de fuente DIRECT FLUIA,hostmann,,,bidón x 10 kilos,2008-07-08,salida,,0.3,27.5,,
Solución de fuente DIRECT FLUIA,hostmann,,,bidón x 10 kilos,2008-07-21,salida,,0.3,27.2,,
Solución de fuente DIRECT FLUIA,hostmann,,,bidón x 10 kilos,2008-08-13,salida,,0.7,26.5,,
Solución de fuente DIRECT FLUIA,hostmann,,,bidón x 10 kilos,2008-08-26,salida,,0.3,26.2,,
Solución de fuente DIRECT FLUIA,hostmann,,,bidón x 10 kilos,2008-11-06,salida,,0.3,25.9,,
Solución de fuente DIRECT FLUIA,hostmann,,,bidón x 10 kilos,2008-12-01,salida,,0.9,25,,
Solución de fuente DIRECT FLUIA,hostmann,,,bidón x 10 kilos,2008-12-11,salida,,0.1,24.9,,
Solución de fuente DIRECT FLUIA,hostmann,,,bidón x 10 kilos,2009-02-02,salida,,0.5,24.4,,
Solución de fuente DIRECT FLUIA,hostmann,,,bidón x 10 kilos,2009-07-20,salida,,0.5,23.9,,
Solución de fuente DIRECT FLUIA,hostmann,,,bidón x 10 kilos,2009-08-25,salida,,1.5,22.4,,
Solución de fuente DIRECT FLUIA,hostmann,,,bidón x 10 kilos,2009-08-27,salida,,0.4,22,,
Solución de fuente DIRECT FLUIA,hostmann,,,bidón x 10 kilos,2009-09-02,salida,,2,20,,
Solución de fuente DIRECT FLUIA,hostmann,,,bidón x 10 kilos,2009-11-02,salida,,0.75,19.25,,
Solución de fuente DIRECT FLUIA,hostmann,,,bidón x 10 kilos,2009-12-17,salida,,0.75,18.5,,
Solución de fuente DIRECT FLUIA,hostmann,,,bidón x 10 kilos,2010-02-12,salida,,0.86,17.64,,
Solución de fuente DIRECT FLUIA,hostmann,,,bidón x 10 kilos,2010-03-25,salida,,0.9,16.74,,
Solución de fuente DIRECT FLUIA,hostmann,,,bidón x 10 kilos,2010-06-01,salida,,0.9,15.84,,
Solución de fuente DIRECT FLUIA,hostmann,,,bidón x 10 kilos,2010-07-14,salida,,0.9,14.94,,
Solución de fuente DIRECT FLUIA,hostmann,,,bidón x 10 kilos,2010-08-16,salida,,1,13.94,,
Solución de fuente DIRECT FLUIA,hostmann,,,bidón x 10 kilos,2010-10-18,salida,,1.25,12.69,,
Solución de fuente DIRECT FLUIA,hostmann,,,bidón x 10 kilos,2010-10-28,entrada,PE 01757 20 litros,20,32.69,7.5,150
Solución de fuente DIRECT FLUIA,hostmann,,,bidón x 10 kilos,2010-11-16,salida,cambio total recirculado,5.2,27.49,,
Solución de fuente DIRECT FLUIA,hostmann,,,bidón x 10 kilos,2011-01-05,salida,4 litros mas 490 mililitros,4.49,23,,
Solución de fuente DIRECT FLUIA,hostmann,,,bidón x 10 kilos,2011-07-18,salida,4 litros mas 750 mililitros,4.75,18.25,,
Solución de fuente DIRECT FLUIA,hostmann,,,bidón x 10 kilos,2011-10-17,salida,1 litro,1,17.25,,
Solución de fuente DIRECT FLUIA,hostmann,,,bidón x 10 kilos,2011-12-07,salida,4 litros,4,13.25,,
Trapo industrial color,,,color,kilogramos,2004-12-30,entrada,O/C 983 - PE 01452,50,50,,
Trapo industrial color,,,color,kilogramos,2005-03-10,salida,,3,47,,
Trapo industrial color,,,color,kilogramos,2005-11-03,salida,,4,43,,
Trapo industrial color,,,color,kilogramos,2006-01-02,salida,,3,40,,
Trapo industrial color,,,color,kilogramos,2006-05-12,salida,,1,39,,
Trapo industrial color,,,color,kilogramos,2006-08-03,salida,,1,38,,
Trapo industrial color,,,color,kilogramos,2006-08-23,salida,,1,37,,
Trapo industrial color,,,color,kilogramos,2006-09-21,salida,,1,36,,
Trapo industrial color,,,color,kilogramos,2006-12-13,salida,,1,35,,
Trapo industrial color,,,color,kilogramos,2007-01-18,salida,,1,34,,
Trapo industrial color,,,color,kilogramos,2007-01-24,salida,,3,31,,
Trapo industrial color,,,color,kilogramos,2007-05-15,salida,,4,27,,
Trapo industrial color,,,color,kilogramos,2007-07-27,salida,,3,24,,
Trapo industrial color,,,color,kilogramos,2007-08-09,salida,,3,21,,
Trapo industrial color,,,color,kilogramos,2007-10-02,salida,,2,19,,
Trapo industrial color,,,color,kilogramos,2008-04-14,salida,,2,17,,
Trapo industrial color,,,color,kilogramos,2008-06-11,salida,,1,16,,
Trapo industrial color,,,color,kilogramos,2008-09-16,salida,,1,15,,
Trapo industrial color,,,color,kilogramos,2008-12-05,salida,,1,14,,
Trapo industrial color,,,color,kilogramos,2009-01-21,salida,,1,13,,
Trapo industrial color,,,color,kilogramos,2009-06-01,salida,,3,10,,
Trapo industrial color,,,color,kilogramos,2009-12-04,salida,,2,8,,
Trapo industrial color,,,color,kilogramos,2010-03-23,salida,,1,7,,
Trapo industrial color,,,color,kilogramos,2010-06-10,salida,,1,6,,
Trapo industrial color,,,color,kilogramos,2010-08-13,salida,,1,5,,
Trapo industrial color,,,color,kilogramos,2011-01-02,salida,,2,3,,
Trapo industrial color,,,color,kilogramos,2011-06-09,salida,,2,1,,
Trapo industrial color,,,color,kilogramos,2011-08-26,entrada,PE 01103 - 40 kilogramos de color,40,41,3.5,140
Trapo industrial blanco,,,blanco,kilogramos,2011-08-26,entrada,PE 01103 - 8 kilogramos blanco,8,8,4.5,36
Tinta especial color reflejo azul,,44515209,,lata x kg,2004-12-30,entrada,O/C 1024 - PEO1461 Saldo al 3/11/2005,1,1,,
Tinta blanco opaco,FLINTINK,44515204,,lata x kg,2004-11-19,entrada,O/C 981 - PE 01197,8,8,,
Tinta blanco opaco,FLINTINK,44515204,,lata x kg,2005-03-10,salida,,2,6,,
Tinta blanco opaco,FLINTINK,44515204,,lata x kg,2005-11-03,entrada,se encontró en uso 1,1,7,,
Tinta blanco opaco,FLINTINK,44515204,,lata x kg,2008-03-14,salida,,1,6,,
Tinta blanco transparente,hostmann,,,kilogramos,2005-05-17,entrada,O/C 197,4,4,,
Tinta blanco transparente,hostmann,,,kilogramos,2010-04-06,salida,,1,3,,
Tinta blanco transparente,hostmann,,,kilogramos,2011-07-11,salida,,1,2,,
Tinta blanco transparente sin secante,grapex,,,2K,2005-11-08,entrada,1 sobrante encontrado al arreglar la oficina de publicaciones,1,1,,
Tinta blanco transparente sin secante,grapex,,,2K,2006-02-20,entrada,Se encontró 2,2,3,,
Tinta blanco transparente sin secante,grapex,,,2K,2006-12-04,salida,,1,2,,
Tinta blanco transparente sin secante,grapex,,,2K,2010-04-06,salida,,1,1,,
Tinta china,PELIKAN,,,frasquitos,2007-01-31,entrada,,101,101,,
Tinta china,PELIKAN,,,frasquitos,2007-01-31,salida,,17,84,,
Tinta china,PELIKAN,,,frasquitos,2009-09-24,salida,,19,65,,
Tinta china,PELIKAN,,,frasquitos,2010-04-06,salida,,5,60,,
Tinta magenta (selección),,,,kilogramo (2.5kg x lata),2005-05-17,entrada,O/C 197,6,6,,
Tinta magenta (selección),,,,kilogramo (2.5kg x lata),2005-11-03,salida,,1,5,,
Tinta magenta (selección),,,,kilogramo (2.5kg x lata),2007-01-25,salida,,1,4,,
Tinta magenta (selección),,,,kilogramo (2.5kg x lata),2008-11-06,salida,,1,3,,
Tinta magenta (selección),,,,kilogramo (2.5kg x lata),2010-05-05,salida,,1,2,,
Tinta magenta (selección),,,,kilogramo (2.5kg x lata),2011-10-12,salida,,1,1,,
Tinta negro (selección),hostmann,,,kilogramo (2.5kg x lata),2005-05-17,entrada,O/C 197,6,6,,
Tinta negro (selección),hostmann,,,kilogramo (2.5kg x lata),2005-11-03,salida,,1,5,,
Tinta negro (selección),hostmann,,,kilogramo (2.5kg x lata),2007-01-31,salida,,1,4,,
Tinta negro (selección),hostmann,,,kilogramo (2.5kg x lata),2008-09-26,salida,,1,3,,
Tinta negro (selección),hostmann,,,kilogramo (2.5kg x lata),2010-06-04,salida,,1,2,,
Tinta negro (selección),hostmann,,,kilogramo (2.5kg x lata),2011-09-08,salida,,1,1,,
Tinta negra bond,imagen bandson,,,,2005-03-10,entrada,O/C 982,8,8,,
Tinta negra bond,imagen bandson,,,,2005-11-03,salida,,1,7,,
Tinta negra bond,imagen bandson,,,,2006-08-07,salida,,2,5,,
Tinta negra bond,imagen bandson,,,,2007-12-11,salida,,1,4,,
Tinta negra bond,imagen bandson,,,,2010-04-06,salida,,1,3,,
Tinta negra bond,imagen bandson,,,,2010-04-19,salida,,1,2,,
Tinta alpha negro bond,hostmann,,,kilogramo,2005-05-17,entrada,O/C 197,5,5,,
Tinta alpha negro bond,hostmann,,,kilogramo,2006-05-16,salida,,1,4,,
Tinta alpha negro bond,hostmann,,,kilogramo,2006-09-18,salida,,1,3,,
Tinta alpha negro bond,hostmann,,,kilogramo,2007-11-23,salida,,1,2,,
Tinta Saphira TO2 black,,,black,lata x 2.5 kg,2011-09-26,entrada,,2,2,90,180
Tinta Saphira TO2 yellow,,,yellow,lata x 2.5 kg,2011-09-26,entrada,,2,2,90,180
Tinta Saphira TO2 cyan,,,cyan,lata x 2.5 kg,2011-09-26,entrada,,2,2,90,180
Tinta Saphira TO2 cyan,,,cyan,lata x 2.5 kg,2011-12-14,salida,,1,1,,
Tinta Saphira TO2 magenta,,,magenta,lata x 2.5 kg,2011-09-26,entrada,,2,2,90,180
Toner GPR 20 black,,,black,,2010-08-25,entrada,,6,6,310,1860
Toner GPR 20 black,,,black,,2010-08-27,salida,,1,5,,
Toner GPR 20 black,,,black,,2010-10-18,salida,,1,4,,
Toner GPR 20 black,,,black,,2011-08-11,salida,,1,3,,
Toner GPR 20 black,,,black,,2011-10-27,salida,,1,2,,
Toner GPR 20 black,,,black,,2011-11-21,salida,,1,1,,
Toner GPR 20 black,,,black,,2011-12-12,salida,,1,0,,
Toner GPR 20 cyan,,,cyan,,2010-08-25,entrada,,4,4,530,2120
Toner GPR 20 cyan,,,cyan,,2010-12-14,salida,,1,3,,
Toner GPR 20 cyan,,,cyan,,2011-10-12,salida,,1,2,,
Toner GPR 20 cyan,,,cyan,,2011-12-14,salida,,1,1,,
Toner GPR 20 magenta,,,magenta,,2010-08-25,entrada,,4,4,530,2120
Toner GPR 20 magenta,,,magenta,,2011-10-12,salida,,1,3,,
Toner GPR 20 yellow,,,yellow,,2010-08-25,entrada,,6,6,530,3180
Toner GPR 20 yellow,,,yellow,,2011-08-11,salida,,1,5,,
Toner GPR 20 yellow,,,yellow,,2011-10-17,salida,,1,4,,
Toner GPR 20 yellow,,,yellow,,2011-11-09,salida,,1,3,,
